,,Republican,Democratic,Approval Voting,Unity Party of Colorado,Unaffiliated,Total Votes Cast,Total Ballots Cast
U.S. Congressperson District,8,163320,160871,5741,3677,7,333616,333616
County,Adams,86842,108131,3494,2435,7,200909,200909
Precinct,8134801162,610,312,8,3,0,933,933
Precinct,8134801163,418,197,7,5,0,627,627
Precinct,8134801170,417,499,20,22,0,958,958
Precinct,8134801171,490,522,23,22,0,1057,1057
Precinct,8134801172,141,105,2,4,0,252,252
Precinct,8134801173,43,35,1,1,0,80,80
Precinct,8134801174,272,160,6,4,0,442,442
Precinct,8134801175,701,506,17,12,0,1236,1236
Precinct,8134801176,395,326,10,4,0,735,735
Precinct,8134801177,336,171,6,3,0,516,516
Precinct,8134801178,391,310,9,8,0,718,718
Precinct,8134801179,188,140,0,2,0,330,330
Precinct,8134801180,468,342,14,3,0,827,827
Precinct,8134801181,579,467,12,13,0,1071,1071
Precinct,8134801182,394,311,13,4,0,722,722
Precinct,8134801183,211,141,5,3,0,360,360
Precinct,8134801184,176,119,8,5,0,308,308
Precinct,8134801185,309,198,16,3,0,526,526
Precinct,8134801186,573,454,18,16,0,1061,1061
Precinct,8134801187,418,354,21,9,0,802,802
Precinct,8134801188,386,278,15,8,0,687,687
Precinct,8134801189,397,279,13,4,0,693,693
Precinct,8134801190,520,390,24,18,0,952,952
Precinct,8134801191,565,565,30,25,0,1185,1185
Precinct,8134801192,298,350,13,2,0,663,663
Precinct,8134801193,462,416,27,9,0,914,914
Precinct,8134801194,205,132,7,3,0,347,347
Precinct,8134801195,217,223,3,1,0,444,444
Precinct,8134801196,276,214,7,3,0,500,500
Precinct,8134801197,137,153,6,5,0,301,301
Precinct,8134801198,564,396,19,9,0,988,988
Precinct,8134801227,214,105,3,0,0,322,322
Precinct,8213201003,0,0,0,0,0,0,0
Precinct,8213201117,438,728,25,14,0,1205,1205
Precinct,8213201118,277,434,20,18,0,749,749
Precinct,8213201119,340,568,30,25,0,963,963
Precinct,8213201120,317,623,17,16,0,973,973
Precinct,8213201121,327,514,26,16,0,883,883
Precinct,8213201122,215,324,13,7,0,559,559
Precinct,8213201123,342,581,29,30,0,982,982
Precinct,8213201124,307,617,15,10,0,949,949
Precinct,8213201125,251,383,14,7,0,655,655
Precinct,8213201126,379,606,26,30,0,1041,1041
Precinct,8213201127,258,396,20,17,0,691,691
Precinct,8213201128,293,461,27,17,0,798,798
Precinct,8213201129,356,551,13,22,0,942,942
Precinct,8213201140,240,316,13,8,0,577,577
Precinct,8213201141,462,630,28,14,0,1134,1134
Precinct,8213201199,412,285,13,4,0,714,714
Precinct,8213201200,73,32,0,0,0,105,105
Precinct,8213201201,326,297,9,1,0,633,633
Precinct,8213201202,306,224,9,1,0,540,540
Precinct,8213201203,392,410,3,7,0,812,812
Precinct,8213201204,277,288,16,2,0,583,583
Precinct,8213201205,559,537,13,16,0,1125,1125
Precinct,8213201206,588,514,22,9,0,1133,1133
Precinct,8213201207,294,314,11,12,0,631,631
Precinct,8213201208,188,228,10,5,0,431,431
Precinct,8213201209,586,789,27,19,0,1421,1421
Precinct,8213201210,544,575,18,10,0,1147,1147
Precinct,8213201211,172,186,6,2,0,366,366
Precinct,8213201212,568,625,18,16,0,1227,1227
Precinct,8213201213,389,529,15,8,0,941,941
Precinct,8213201214,451,530,13,12,0,1006,1006
Precinct,8213201215,531,432,17,6,0,986,986
Precinct,8213201216,622,710,20,23,0,1375,1375
Precinct,8213201217,354,399,9,8,0,770,770
Precinct,8213201218,454,442,18,10,0,924,924
Precinct,8213201219,291,423,11,6,0,731,731
Precinct,8213201220,208,283,8,4,0,503,503
Precinct,8213201221,172,232,4,3,0,411,411
Precinct,8213201222,369,502,12,5,0,888,888
Precinct,8213201223,63,79,2,1,0,145,145
Precinct,8213201224,107,134,2,0,0,243,243
Precinct,8213201225,73,40,0,3,0,116,116
Precinct,8213201254,213,292,11,9,0,525,525
Precinct,8213201255,140,226,18,18,0,402,402
Precinct,8213201261,320,285,8,4,0,617,617
Precinct,8213201276,126,206,5,9,0,346,346
Precinct,8213501001,235,679,16,23,0,953,953
Precinct,8213501002,156,371,2,5,0,534,534
Precinct,8213501004,250,381,8,8,0,647,647
Precinct,8213501005,353,741,27,15,0,1136,1136
Precinct,8213501006,259,474,25,21,0,779,779
Precinct,8213501007,430,607,19,8,0,1064,1064
Precinct,8213501010,348,617,23,17,0,1005,1005
Precinct,8213501011,133,307,11,8,0,459,459
Precinct,8213501012,342,543,19,9,0,913,913
Precinct,8213501013,439,841,32,19,0,1331,1331
Precinct,8213501014,311,451,29,17,0,808,808
Precinct,8213501017,220,331,17,9,0,577,577
Precinct,8213501018,246,339,10,10,0,605,605
Precinct,8213501019,230,346,11,2,0,589,589
Precinct,8213501020,288,547,23,15,0,873,873
Precinct,8213501021,366,644,31,17,0,1058,1058
Precinct,8213501022,345,623,21,22,0,1011,1011
Precinct,8213501023,221,489,15,19,0,744,744
Precinct,8213501024,347,632,19,14,0,1012,1012
Precinct,8213501025,335,620,25,6,0,986,986
Precinct,8213501026,126,262,9,12,0,409,409
Precinct,8213501257,263,802,13,6,0,1084,1084
Precinct,8213501262,284,492,13,19,0,808,808
Precinct,8213501270,251,561,4,16,0,832,832
Precinct,8213501271,227,531,12,15,0,785,785
Precinct,8213501275,301,613,16,16,0,946,946
Precinct,8214801226,188,74,5,3,0,270,270
Precinct,8215601228,454,208,7,13,0,682,682
Precinct,8215601268,55,19,0,0,0,74,74
Precinct,8243101028,259,442,13,8,1,723,723
Precinct,8243101029,318,637,22,10,0,987,987
Precinct,8243101037,195,377,11,8,0,591,591
Precinct,8243101038,443,654,25,21,0,1143,1143
Precinct,8243101041,349,514,31,10,0,904,904
Precinct,8243101097,252,300,14,3,0,569,569
Precinct,8243101103,150,262,11,17,0,440,440
Precinct,8243101105,61,54,3,6,0,124,124
Precinct,8243101106,489,734,13,12,0,1248,1248
Precinct,8243101107,496,759,23,21,0,1299,1299
Precinct,8243101108,434,671,23,19,0,1147,1147
Precinct,8243101109,399,560,13,9,0,981,981
Precinct,8243101110,268,394,18,9,0,689,689
Precinct,8243101111,391,521,17,10,0,939,939
Precinct,8243101112,271,453,25,11,0,760,760
Precinct,8243101113,361,564,29,16,0,970,970
Precinct,8243101114,279,483,13,18,0,793,793
Precinct,8243101115,326,519,22,14,0,881,881
Precinct,8243101116,198,236,14,9,0,457,457
Precinct,8243101131,233,331,14,2,0,580,580
Precinct,8243101132,331,472,16,10,0,829,829
Precinct,8243101133,535,645,25,19,0,1224,1224
Precinct,8243101134,468,647,17,14,0,1146,1146
Precinct,8243101135,533,655,26,18,0,1232,1232
Precinct,8243101136,399,466,16,15,0,896,896
Precinct,8243101137,586,703,17,19,0,1325,1325
Precinct,8243101138,436,425,19,5,0,885,885
Precinct,8243101139,209,256,5,4,0,474,474
Precinct,8243101142,608,489,14,8,0,1119,1119
Precinct,8243101143,379,458,9,6,0,852,852
Precinct,8243101144,574,610,19,13,0,1216,1216
Precinct,8243101145,560,704,14,10,0,1288,1288
Precinct,8243101146,186,237,8,12,0,443,443
Precinct,8243101147,637,804,25,11,0,1477,1477
Precinct,8243101148,377,413,14,13,0,817,817
Precinct,8243101250,159,291,5,14,0,469,469
Precinct,8243101263,178,336,5,6,0,525,525
Precinct,8243101274,0,0,0,0,0,0,0
Precinct,8243201130,58,86,1,2,0,147,147
Precinct,8243301071,415,386,10,6,0,817,817
Precinct,8243301072,559,553,17,10,1,1140,1140
Precinct,8243301073,493,478,20,11,0,1002,1002
Precinct,8243301074,504,488,11,6,0,1009,1009
Precinct,8243301075,330,371,8,10,0,719,719
Precinct,8243301158,607,666,27,12,0,1312,1312
Precinct,8243301160,780,714,11,17,0,1522,1522
Precinct,8243301161,635,504,7,7,0,1153,1153
Precinct,8243301165,796,772,13,6,0,1587,1587
Precinct,8243301259,125,81,2,1,0,209,209
Precinct,8243401076,508,606,19,12,0,1145,1145
Precinct,8243401077,302,260,4,4,0,570,570
Precinct,8243401078,341,361,5,4,0,711,711
Precinct,8243401079,320,402,12,3,0,737,737
Precinct,8243401080,436,427,14,7,0,884,884
Precinct,8243401081,411,480,11,9,0,911,911
Precinct,8243401082,372,521,13,9,0,915,915
Precinct,8243401083,430,530,13,5,0,978,978
Precinct,8243401084,311,321,6,4,0,642,642
Precinct,8243401085,422,567,14,7,0,1010,1010
Precinct,8243401086,446,448,17,13,0,924,924
Precinct,8243401087,391,536,11,15,0,953,953
Precinct,8243401088,498,673,18,12,0,1201,1201
Precinct,8243401089,417,576,18,13,0,1024,1024
Precinct,8243401093,537,585,13,20,1,1156,1156
Precinct,8243401094,517,552,21,13,0,1103,1103
Precinct,8243401149,484,523,18,4,0,1029,1029
Precinct,8243401150,539,753,17,15,0,1324,1324
Precinct,8243401151,547,648,9,11,0,1215,1215
Precinct,8243401152,565,555,23,6,0,1149,1149
Precinct,8243401153,414,340,7,7,0,768,768
Precinct,8243401155,655,525,18,15,0,1213,1213
Precinct,8243401156,444,409,17,4,0,874,874
Precinct,8243401157,398,428,10,7,0,843,843
Precinct,8243401159,357,417,8,5,0,787,787
Precinct,8243401252,568,716,13,9,0,1306,1306
Precinct,8243401256,623,565,10,6,0,1204,1204
Precinct,8243401264,212,207,7,4,0,430,430
Precinct,8243401265,157,188,14,9,0,368,368
Precinct,8243501027,172,345,12,6,0,535,535
Precinct,8243501030,285,357,20,23,0,685,685
Precinct,8243501035,262,435,15,18,0,730,730
Precinct,8243501036,272,371,19,14,0,676,676
Precinct,8243501042,276,453,19,10,0,758,758
Precinct,8244801154,25,7,0,0,0,32,32
Precinct,8244801164,242,118,0,3,0,363,363
Precinct,8244801166,292,146,4,3,0,445,445
Precinct,8244801167,368,188,5,2,0,563,563
Precinct,8244801168,61,26,0,3,0,90,90
Precinct,8244801169,270,131,6,6,0,413,413
Precinct,8252901032,222,331,11,8,0,572,572
Precinct,8252901033,483,829,17,19,0,1348,1348
Precinct,8252901034,386,542,31,17,1,977,977
Precinct,8252901043,331,543,9,8,0,891,891
Precinct,8252901044,330,541,12,10,0,893,893
Precinct,8252901045,293,334,6,7,0,640,640
Precinct,8252901046,290,377,2,3,0,672,672
Precinct,8252901047,377,611,8,6,0,1002,1002
Precinct,8252901048,355,463,8,1,0,827,827
Precinct,8252901049,396,565,14,10,0,985,985
Precinct,8252901050,313,499,21,6,0,839,839
Precinct,8252901054,295,478,12,5,0,790,790
Precinct,8252901055,303,421,9,5,0,738,738
Precinct,8252901056,422,734,13,6,0,1175,1175
Precinct,8252901057,344,499,7,5,0,855,855
Precinct,8252901058,317,734,17,10,0,1078,1078
Precinct,8252901059,352,644,10,6,0,1012,1012
Precinct,8252901060,436,480,19,5,0,940,940
Precinct,8252901061,387,656,11,12,0,1066,1066
Precinct,8252901062,427,537,5,7,0,976,976
Precinct,8252901063,422,625,11,3,0,1061,1061
Precinct,8252901064,419,692,28,22,0,1161,1161
Precinct,8252901065,365,636,12,8,0,1021,1021
Precinct,8252901066,202,315,8,7,0,532,532
Precinct,8252901067,233,295,8,3,0,539,539
Precinct,8252901068,411,738,14,5,0,1168,1168
Precinct,8252901069,569,662,14,11,0,1256,1256
Precinct,8252901070,445,381,5,4,0,835,835
Precinct,8253301277,17,18,0,0,0,35,35
Precinct,8253401039,321,455,17,12,0,805,805
Precinct,8253401040,385,445,14,19,0,863,863
Precinct,8253401051,546,627,16,21,0,1210,1210
Precinct,8253401052,256,321,16,7,0,600,600
Precinct,8253401053,421,545,12,7,0,985,985
Precinct,8253401090,311,455,30,19,0,815,815
Precinct,8253401091,355,491,22,16,0,884,884
Precinct,8253401092,558,580,25,11,0,1174,1174
Precinct,8253401095,465,522,30,10,0,1027,1027
Precinct,8253401096,392,429,16,15,0,852,852
Precinct,8253401098,400,443,19,12,0,874,874
Precinct,8253401099,266,342,12,6,0,626,626
Precinct,8253401100,421,579,39,19,0,1058,1058
Precinct,8253401101,434,626,24,13,0,1097,1097
Precinct,8253401102,393,497,18,13,0,921,921
Precinct,8253401104,365,524,20,10,2,921,921
Precinct,8253401273,235,429,10,12,0,686,686
Precinct,8253401278,212,417,12,5,0,646,646
Precinct,8253501015,378,575,25,23,0,1001,1001
Precinct,8253501016,410,692,26,13,1,1142,1142
Precinct,8253501031,348,562,13,7,0,930,930
Precinct,8253501272,308,429,12,7,0,756,756
County,Larimer,7267,5787,224,111,0,13389,13389
Precinct,8236435505,815,702,24,8,0,1549,1549
Precinct,8236435506,946,757,28,12,0,1743,1743
Precinct,8236435510,804,703,32,15,0,1554,1554
Precinct,8236435511,912,839,30,20,0,1801,1801
Precinct,8236435512,1059,834,34,18,0,1945,1945
Precinct,8236435513,703,521,21,7,0,1252,1252
Precinct,8236535501,1003,742,27,16,0,1788,1788
Precinct,8236535502,1025,689,28,15,0,1757,1757
County,Weld,69211,46953,2023,1131,0,119318,119318
Precinct,8014862135,36,23,0,0,0,59,59
Precinct,8014862304,573,371,19,11,0,974,974
Precinct,8014862305,539,334,23,6,0,902,902
Precinct,8014862306,384,324,16,10,0,734,734
Precinct,8014862307,648,343,13,7,0,1011,1011
Precinct,8014862308,580,188,14,8,0,790,790
Precinct,8014862309,762,205,15,3,0,985,985
Precinct,8014862310,852,208,16,8,0,1084,1084
Precinct,8014862311,723,269,24,4,0,1020,1020
Precinct,8015062400,0,0,0,0,0,0,0
Precinct,8015062401,0,0,0,0,0,0,0
Precinct,8015062403,0,0,0,0,0,0,0
Precinct,8015062500,0,0,0,0,0,0,0
Precinct,8015062600,0,0,0,0,0,0,0
Precinct,8015062602,0,0,0,0,0,0,0
Precinct,8016362134,912,199,14,7,0,1132,1132
Precinct,8016362329,364,75,3,3,0,445,445
Precinct,8016462148,493,393,12,6,0,904,904
Precinct,8016462149,620,406,14,16,0,1056,1056
Precinct,8016462150,636,364,13,7,0,1020,1020
Precinct,8016462151,655,438,15,6,0,1114,1114
Precinct,8016462152,374,250,9,5,0,638,638
Precinct,8016462153,854,515,19,10,0,1398,1398
Precinct,8016462154,656,388,4,6,0,1054,1054
Precinct,8016462245,780,528,19,9,0,1336,1336
Precinct,8016462246,603,500,8,12,0,1123,1123
Precinct,8016462247,731,459,14,4,0,1208,1208
Precinct,8016462248,649,472,8,12,0,1141,1141
Precinct,8016462249,707,500,18,18,0,1243,1243
Precinct,8016462250,700,421,12,13,0,1146,1146
Precinct,8016462251,948,502,27,13,0,1490,1490
Precinct,8016462252,627,415,17,2,0,1061,1061
Precinct,8016462253,535,328,10,9,0,882,882
Precinct,8016462254,409,239,3,4,0,655,655
Precinct,8016462255,598,405,15,7,0,1025,1025
Precinct,8016462256,558,304,4,9,0,875,875
Precinct,8016462257,729,485,17,6,0,1237,1237
Precinct,8016462258,905,695,30,16,0,1646,1646
Precinct,8016562155,514,88,3,2,0,607,607
Precinct,8134862222,154,57,0,1,0,212,212
Precinct,8134862312,496,246,10,5,0,757,757
Precinct,8134862313,1008,612,27,13,0,1660,1660
Precinct,8134862314,405,313,12,14,0,744,744
Precinct,8134862315,577,372,24,7,0,980,980
Precinct,8134862316,535,445,15,13,0,1008,1008
Precinct,8134862317,454,243,25,9,0,731,731
Precinct,8134862318,766,373,16,9,0,1164,1164
Precinct,8134862319,743,355,12,11,0,1121,1121
Precinct,8134862320,679,414,36,12,0,1141,1141
Precinct,8135062136,187,340,21,4,0,552,552
Precinct,8135062137,229,342,18,12,0,601,601
Precinct,8135062138,400,729,28,17,0,1174,1174
Precinct,8135062139,403,412,16,11,0,842,842
Precinct,8135062140,302,370,12,6,0,690,690
Precinct,8135062141,382,545,14,8,0,949,949
Precinct,8135062142,469,722,42,23,0,1256,1256
Precinct,8135062143,497,540,18,7,0,1062,1062
Precinct,8135062144,332,403,13,14,0,762,762
Precinct,8135062145,497,604,31,13,0,1145,1145
Precinct,8135062146,626,630,31,28,0,1315,1315
Precinct,8135062147,370,422,25,10,0,827,827
Precinct,8135062235,731,697,34,19,0,1481,1481
Precinct,8135062236,531,403,5,10,0,949,949
Precinct,8135062237,760,516,17,15,0,1308,1308
Precinct,8135062238,481,325,21,8,0,835,835
Precinct,8135062239,408,168,6,2,0,584,584
Precinct,8135062330,51,13,1,1,0,66,66
Precinct,8135062331,442,359,14,15,0,830,830
Precinct,8135062332,699,534,29,32,0,1294,1294
Precinct,8135062333,405,406,19,6,0,836,836
Precinct,8135062345,556,431,20,10,0,1017,1017
Precinct,8135062346,653,451,29,9,0,1142,1142
Precinct,8135062347,555,446,23,6,0,1030,1030
Precinct,8135062348,306,301,13,11,0,631,631
Precinct,8135062349,379,416,16,12,0,823,823
Precinct,8135062350,267,327,10,14,0,618,618
Precinct,8135062351,451,479,18,16,0,964,964
Precinct,8135062352,423,553,17,11,0,1004,1004
Precinct,8135062360,47,67,1,4,0,119,119
Precinct,8136362404,0,0,0,0,0,0,0
Precinct,8136462240,162,143,9,2,0,316,316
Precinct,8136462241,513,514,18,8,0,1053,1053
Precinct,8136462242,600,441,23,10,0,1074,1074
Precinct,8136462243,560,541,13,13,0,1127,1127
Precinct,8136462244,608,447,22,13,0,1090,1090
Precinct,8136462264,0,0,0,0,0,0,0
Precinct,8136462501,0,0,0,0,0,0,0
Precinct,8231962220,662,553,14,6,0,1235,1235
Precinct,8231962221,518,399,14,4,0,935,935
Precinct,8231962223,1029,729,22,13,0,1793,1793
Precinct,8231962224,522,403,21,15,0,961,961
Precinct,8231962225,763,593,17,12,0,1385,1385
Precinct,8231962226,811,528,21,11,0,1371,1371
Precinct,8231962227,913,590,28,10,0,1541,1541
Precinct,8231962228,753,524,19,7,0,1303,1303
Precinct,8231962229,753,475,25,9,0,1262,1262
Precinct,8231962230,1064,782,30,21,0,1897,1897
Precinct,8231962231,772,525,23,8,0,1328,1328
Precinct,8231962232,751,648,43,11,0,1453,1453
Precinct,8231962233,623,420,21,7,0,1071,1071
Precinct,8231962234,641,435,19,10,0,1105,1105
Precinct,8231962262,229,232,12,13,0,486,486
Precinct,8231962263,682,424,13,5,0,1124,1124
Precinct,8231962323,236,73,5,0,0,314,314
Precinct,8231962324,549,430,22,8,0,1009,1009
Precinct,8231962325,921,595,18,13,0,1547,1547
Precinct,8231962326,473,387,12,7,0,879,879
Precinct,8231962327,437,299,12,5,0,753,753
Precinct,8231962328,505,427,21,13,0,966,966
Precinct,8233362601,0,0,0,0,0,0,0
Precinct,8234862216,85,8,1,1,0,95,95
Precinct,8234862217,115,36,4,3,0,158,158
Precinct,8234862321,180,49,6,0,0,235,235
Precinct,8234862322,48,12,1,0,0,61,61
Precinct,8234862361,28,4,0,0,0,32,32
Precinct,8236462200,983,576,25,12,0,1596,1596
Precinct,8236462201,824,407,13,3,0,1247,1247
Precinct,8236462202,943,482,30,22,0,1477,1477
Precinct,8236462203,777,329,12,10,0,1128,1128
Precinct,8236462204,868,439,23,10,0,1340,1340
Precinct,8236462205,504,264,8,5,0,781,781
Precinct,8236462206,786,326,12,11,0,1135,1135
Precinct,8236462207,587,378,11,11,0,987,987
Precinct,8236462208,827,535,35,12,0,1409,1409
Precinct,8236462209,837,478,19,10,0,1344,1344
Precinct,8236462210,968,462,15,7,0,1452,1452
Precinct,8236462211,823,413,23,10,0,1269,1269
Precinct,8236462212,739,302,21,9,0,1071,1071
Precinct,8236462213,519,265,10,12,0,806,806
Precinct,8236462214,468,285,18,8,0,779,779
Precinct,8236462215,563,235,20,12,0,830,830
Precinct,8236562156,114,14,6,1,0,135,135
Precinct,8236562259,265,82,6,1,0,354,354