,,Democratic,Republican,Libertarian,Unity Party of Colorado,Total Votes Cast,Total Ballots Cast
U.S. Congressperson District,2,316925,182547,13657,2534,515663,515663
County,Boulder,114509,26505,2709,551,144274,144274
Precinct,2161307900,397,56,5,1,459,459
Precinct,2161307901,401,196,20,2,619,619
Precinct,2161307902,215,50,8,0,273,273
Precinct,2163307100,919,402,18,1,1340,1340
Precinct,2163307101,888,315,28,9,1240,1240
Precinct,2163307102,678,241,41,5,965,965
Precinct,2163307103,761,294,18,3,1076,1076
Precinct,2163307104,716,298,8,5,1027,1027
Precinct,2163307105,315,93,17,0,425,425
Precinct,2163307106,745,216,14,1,976,976
Precinct,2163307107,685,219,20,0,924,924
Precinct,2171207200,434,155,8,1,598,598
Precinct,2171207201,502,122,8,3,635,635
Precinct,2171207202,738,271,11,2,1022,1022
Precinct,2171207203,749,176,18,1,944,944
Precinct,2171207204,712,185,21,1,919,919
Precinct,2171207205,703,160,13,3,879,879
Precinct,2171207206,449,83,4,0,536,536
Precinct,2171207207,727,160,20,3,910,910
Precinct,2171207208,863,145,10,2,1020,1020
Precinct,2171207209,463,119,2,0,584,584
Precinct,2171207210,708,148,17,3,876,876
Precinct,2171207211,725,219,16,2,962,962
Precinct,2171207212,1030,245,30,8,1313,1313
Precinct,2171207213,1035,236,10,0,1281,1281
Precinct,2171207214,904,220,16,5,1145,1145
Precinct,2171207215,577,205,17,3,802,802
Precinct,2171207300,1081,414,40,5,1540,1540
Precinct,2171207301,1118,246,37,9,1410,1410
Precinct,2171207302,1314,373,47,3,1737,1737
Precinct,2171207303,663,139,20,7,829,829
Precinct,2171207304,696,164,15,6,881,881
Precinct,2171207305,771,186,23,7,987,987
Precinct,2171207306,854,191,27,1,1073,1073
Precinct,2171207307,789,215,29,7,1040,1040
Precinct,2171207308,746,175,22,10,953,953
Precinct,2171207309,810,195,27,3,1035,1035
Precinct,2171207310,1048,262,17,6,1333,1333
Precinct,2171207311,581,141,14,6,742,742
Precinct,2171207312,698,226,16,1,941,941
Precinct,2171207313,939,261,14,7,1221,1221
Precinct,2171207314,1108,255,11,1,1375,1375
Precinct,2171207315,580,176,8,1,765,765
Precinct,2171207316,769,356,13,2,1140,1140
Precinct,2171207407,221,190,10,2,423,423
Precinct,2173307400,66,50,0,0,116,116
Precinct,2173307408,733,464,36,4,1237,1237
Precinct,2173307409,988,524,52,6,1570,1570
Precinct,2173307410,669,407,19,2,1097,1097
Precinct,2173307411,848,397,27,3,1275,1275
Precinct,2173307412,789,362,33,8,1192,1192
Precinct,2173307413,796,407,42,0,1245,1245
Precinct,2173307414,673,383,31,1,1088,1088
Precinct,2181007500,712,91,16,6,825,825
Precinct,2181007501,631,218,7,2,858,858
Precinct,2181007502,665,286,13,0,964,964
Precinct,2181007503,1034,302,29,6,1371,1371
Precinct,2181007504,520,152,13,3,688,688
Precinct,2181007800,620,187,10,2,819,819
Precinct,2181007801,643,91,22,6,762,762
Precinct,2181007802,738,121,28,2,889,889
Precinct,2181007803,790,90,22,4,906,906
Precinct,2181007804,935,200,15,6,1156,1156
Precinct,2181007805,366,75,5,3,449,449
Precinct,2181007806,966,173,25,1,1165,1165
Precinct,2181007807,938,112,13,4,1067,1067
Precinct,2181007808,1390,136,20,9,1555,1555
Precinct,2181007809,1030,104,12,4,1150,1150
Precinct,2181007810,821,124,9,2,956,956
Precinct,2181007811,1027,180,10,4,1221,1221
Precinct,2181007812,981,138,25,1,1145,1145
Precinct,2181007813,653,157,17,4,831,831
Precinct,2181007814,925,90,23,7,1045,1045
Precinct,2181007815,643,82,18,5,748,748
Precinct,2181007816,934,98,29,5,1066,1066
Precinct,2181007817,645,108,6,0,759,759
Precinct,2181007818,870,93,12,3,978,978
Precinct,2181007819,728,77,15,3,823,823
Precinct,2181007820,580,66,12,4,662,662
Precinct,2181007821,863,69,20,8,960,960
Precinct,2181007822,1307,171,43,14,1535,1535
Precinct,2181007823,934,143,18,7,1102,1102
Precinct,2181007824,859,105,18,7,989,989
Precinct,2181007825,524,57,7,5,593,593
Precinct,2181007826,722,62,9,2,795,795
Precinct,2181007827,718,70,12,2,802,802
Precinct,2181007828,573,62,10,0,645,645
Precinct,2181007829,527,57,17,2,603,603
Precinct,2181007830,466,56,11,2,535,535
Precinct,2181007831,560,55,11,5,631,631
Precinct,2181007832,237,40,2,7,286,286
Precinct,2181007833,401,62,9,3,475,475
Precinct,2181007834,195,60,9,6,270,270
Precinct,2181007835,149,23,4,2,178,178
Precinct,2181007836,358,64,6,2,430,430
Precinct,2181007837,510,67,27,4,608,608
Precinct,2181007838,315,44,11,5,375,375
Precinct,2181007839,479,74,9,2,564,564
Precinct,2181007840,444,61,10,0,515,515
Precinct,2181007841,538,104,9,3,654,654
Precinct,2181007842,869,158,14,6,1047,1047
Precinct,2181007843,1047,139,13,3,1202,1202
Precinct,2181007844,552,55,11,1,619,619
Precinct,2181007845,616,71,16,4,707,707
Precinct,2181007846,648,122,22,5,797,797
Precinct,2181007847,362,76,20,2,460,460
Precinct,2181007848,502,41,12,1,556,556
Precinct,2181007849,217,61,12,4,294,294
Precinct,2181007850,515,117,10,1,643,643
Precinct,2181007851,826,116,16,3,961,961
Precinct,2181007852,845,127,19,0,991,991
Precinct,2181007853,603,90,17,9,719,719
Precinct,2181107505,618,178,15,5,816,816
Precinct,2181107506,369,192,7,0,568,568
Precinct,2181107507,697,432,26,0,1155,1155
Precinct,2181107508,564,126,9,0,699,699
Precinct,2181107700,621,225,11,0,857,857
Precinct,2181107701,341,164,9,1,515,515
Precinct,2181107702,208,160,4,1,373,373
Precinct,2181107703,286,137,12,0,435,435
Precinct,2181107704,228,96,12,0,336,336
Precinct,2181107705,355,246,6,1,608,608
Precinct,2181107912,856,193,21,6,1076,1076
Precinct,2181107913,485,139,10,1,635,635
Precinct,2181107916,267,155,12,5,439,439
Precinct,2181107917,933,294,32,3,1262,1262
Precinct,2181107918,802,254,27,1,1084,1084
Precinct,2181207401,465,203,8,3,679,679
Precinct,2181207402,421,158,5,2,586,586
Precinct,2181207403,705,145,10,2,862,862
Precinct,2181207404,636,224,15,1,876,876
Precinct,2181207405,293,146,5,1,445,445
Precinct,2181207406,385,271,16,3,675,675
Precinct,2181307854,746,61,17,5,829,829
Precinct,2181307855,633,73,14,12,732,732
Precinct,2181307856,532,40,7,4,583,583
Precinct,2181307857,661,128,18,2,809,809
Precinct,2181307858,809,90,12,1,912,912
Precinct,2181307859,719,76,10,1,806,806
Precinct,2181307860,545,74,10,1,630,630
Precinct,2181307861,502,66,5,0,573,573
Precinct,2181307862,581,55,4,1,641,641
Precinct,2181307863,620,96,2,2,720,720
Precinct,2181307864,522,55,7,1,585,585
Precinct,2181307865,502,61,13,1,577,577
Precinct,2181307866,673,60,11,2,746,746
Precinct,2181307867,629,64,12,5,710,710
Precinct,2181307868,729,90,14,4,837,837
Precinct,2181307869,477,57,10,1,545,545
Precinct,2181307870,527,44,10,4,585,585
Precinct,2181307871,591,61,11,2,665,665
Precinct,2181307872,416,93,15,4,528,528
Precinct,2181307873,357,60,3,0,420,420
Precinct,2181307874,763,105,10,1,879,879
Precinct,2181307875,235,60,8,2,305,305
Precinct,2181307876,272,77,10,3,362,362
Precinct,2181307877,502,64,9,0,575,575
Precinct,2181307878,463,67,11,5,546,546
Precinct,2181307879,451,57,9,0,517,517
Precinct,2181307880,454,114,15,4,587,587
Precinct,2181307881,488,88,7,4,587,587
Precinct,2181307882,543,69,7,1,620,620
Precinct,2181307883,705,53,11,2,771,771
Precinct,2181307884,672,57,11,4,744,744
Precinct,2181307885,521,52,6,6,585,585
Precinct,2181307886,638,92,7,2,739,739
Precinct,2181307887,780,129,15,0,924,924
Precinct,2181307888,679,123,6,1,809,809
Precinct,2181307903,534,116,12,1,663,663
Precinct,2181307904,405,56,9,3,473,473
Precinct,2181307905,205,48,3,1,257,257
Precinct,2181307906,380,128,9,1,518,518
Precinct,2181307908,724,148,21,4,897,897
Precinct,2181307909,464,43,17,3,527,527
Precinct,2181307910,583,124,18,6,731,731
Precinct,2181307911,712,148,8,1,869,869
Precinct,2181307914,462,90,10,2,564,564
Precinct,2181307915,254,90,14,4,362,362
Precinct,2181307919,861,147,41,6,1055,1055
County,Broomfield,26935,16887,1180,225,45227,45227
Precinct,2233364001,935,509,46,6,1496,1496
Precinct,2233364002,1376,531,71,9,1987,1987
Precinct,2233364003,1108,390,60,6,1564,1564
Precinct,2233364004,926,510,36,12,1484,1484
Precinct,2233364005,50,18,2,1,71,71
Precinct,2233364006,1335,470,86,19,1910,1910
Precinct,2233364007,518,220,21,9,768,768
Precinct,2233364008,360,202,20,12,594,594
Precinct,2233364009,470,265,18,2,755,755
Precinct,2233364010,579,430,22,7,1038,1038
Precinct,2233364011,592,377,43,3,1015,1015
Precinct,2233364012,628,448,18,1,1095,1095
Precinct,2233364013,560,246,29,5,840,840
Precinct,2233364014,554,319,30,8,911,911
Precinct,2233364015,602,422,16,2,1042,1042
Precinct,2233364016,528,508,12,2,1050,1050
Precinct,2233364017,740,682,21,2,1445,1445
Precinct,2233364018,472,279,23,5,779,779
Precinct,2233364019,659,404,56,11,1130,1130
Precinct,2233364020,475,338,28,5,846,846
Precinct,2233364021,1012,549,51,13,1625,1625
Precinct,2233364022,724,452,22,1,1199,1199
Precinct,2233364023,618,379,9,4,1010,1010
Precinct,2233364024,1061,773,42,2,1878,1878
Precinct,2233364025,1041,702,36,6,1785,1785
Precinct,2233364026,625,470,7,3,1105,1105
Precinct,2233364027,789,505,49,4,1347,1347
Precinct,2233364028,229,171,19,7,426,426
Precinct,2233364029,647,447,34,8,1136,1136
Precinct,2233364030,520,398,37,10,965,965
Precinct,2233364031,493,368,31,9,901,901
Precinct,2233364032,1201,803,41,4,2049,2049
Precinct,2233364033,935,577,25,6,1543,1543
Precinct,2233364034,186,405,7,1,599,599
Precinct,2233364035,1327,749,8,4,2088,2088
Precinct,2233364036,1469,1108,68,10,2655,2655
Precinct,2233364037,591,463,36,6,1096,1096
County,Clear Creek,3392,2675,217,41,6325,6325
Precinct,2021310001,525,322,35,7,889,889
Precinct,2021310002,161,131,14,6,312,312
Precinct,2021310003,204,163,17,1,385,385
Precinct,2021310004,411,330,31,8,780,780
Precinct,2021310005,370,286,25,7,688,688
Precinct,2021310006,252,165,15,4,436,436
Precinct,2021310007,582,518,30,3,1133,1133
Precinct,2021310008,374,288,16,1,679,679
Precinct,2021310009,513,472,34,4,1023,1023
County,Eagle,4691,2198,220,58,7167,7167
Precinct,2052619001,106,47,11,2,166,166
Precinct,2052619002,443,213,22,5,683,683
Precinct,2052619003,472,159,18,5,654,654
Precinct,2052619011,361,153,24,7,545,545
Precinct,2052619012,824,362,36,10,1232,1232
Precinct,2052619013,537,308,20,4,869,869
Precinct,2052619014,412,187,22,4,625,625
Precinct,2052619015,731,377,33,13,1154,1154
Precinct,2052619019,805,392,34,8,1239,1239
County,Gilpin,2139,1746,174,33,4092,4092
Precinct,2161324001,265,282,26,7,580,580
Precinct,2161324002,308,375,36,1,720,720
Precinct,2161324003,382,436,29,7,854,854
Precinct,2161324004,333,249,29,1,612,612
Precinct,2161324005,345,229,19,2,595,595
Precinct,2161324006,506,175,35,15,731,731
County,Grand,4348,4781,306,53,9488,9488
Precinct,2081325001,268,318,19,5,610,610
Precinct,2081325002,408,649,33,8,1098,1098
Precinct,2081325003,613,715,36,7,1371,1371
Precinct,2081325004,168,475,19,0,662,662
Precinct,2081325005,265,584,28,2,879,879
Precinct,2081325006,379,216,30,5,630,630
Precinct,2081325007,565,283,37,9,894,894
Precinct,2081325008,203,408,19,6,636,636
Precinct,2081325009,410,201,25,5,641,641
Precinct,2081325010,300,368,23,2,693,693
Precinct,2081325011,333,192,17,3,545,545
Precinct,2081325012,436,372,20,1,829,829
County,Jefferson,29143,26719,1482,242,57586,57586
Precinct,2162530036,881,787,56,5,1729,1729
Precinct,2162530037,655,390,15,2,1062,1062
Precinct,2162530038,704,483,28,5,1220,1220
Precinct,2162530039,614,623,24,5,1266,1266
Precinct,2162530040,788,770,25,0,1583,1583
Precinct,2162530041,515,427,8,1,951,951
Precinct,2162530042,564,523,20,3,1110,1110
Precinct,2162530043,431,357,33,1,822,822
Precinct,2162530044,567,391,36,6,1000,1000
Precinct,2162530045,651,409,23,2,1085,1085
Precinct,2162530046,618,365,31,8,1022,1022
Precinct,2162530047,641,462,27,3,1133,1133
Precinct,2162530048,746,473,37,5,1261,1261
Precinct,2162530049,614,480,28,3,1125,1125
Precinct,2162530050,541,512,26,3,1082,1082
Precinct,2162530051,816,514,29,6,1365,1365
Precinct,2162530052,701,531,39,4,1275,1275
Precinct,2162530053,476,437,24,4,941,941
Precinct,2162530054,647,558,18,3,1226,1226
Precinct,2162530055,324,223,17,3,567,567
Precinct,2162530056,490,494,13,9,1006,1006
Precinct,2162530057,577,585,28,5,1195,1195
Precinct,2162530058,742,822,42,8,1614,1614
Precinct,2162530059,547,580,56,4,1187,1187
Precinct,2162530060,240,292,21,2,555,555
Precinct,2162530061,651,521,32,6,1210,1210
Precinct,2162530062,613,666,36,8,1323,1323
Precinct,2162530063,505,493,27,6,1031,1031
Precinct,2162530064,223,364,9,2,598,598
Precinct,2162530065,614,744,50,2,1410,1410
Precinct,2162530066,603,634,30,5,1272,1272
Precinct,2162530067,550,549,43,3,1145,1145
Precinct,2162530068,385,514,19,2,920,920
Precinct,2202230069,303,238,18,4,563,563
Precinct,2202530070,876,707,69,13,1665,1665
Precinct,2202530071,718,745,41,7,1511,1511
Precinct,2202530072,819,758,54,11,1642,1642
Precinct,2202530073,543,524,34,9,1110,1110
Precinct,2202530074,777,816,35,8,1636,1636
Precinct,2202530075,809,822,50,13,1694,1694
Precinct,2202530076,724,760,36,13,1533,1533
Precinct,2202530077,685,869,21,2,1577,1577
Precinct,2202530078,703,566,26,2,1297,1297
Precinct,2202530079,422,334,21,1,778,778
Precinct,2202530080,499,622,17,4,1142,1142
Precinct,2202530284,328,282,23,9,642,642
Precinct,2222230081,661,706,36,7,1410,1410
Precinct,2222230082,604,614,34,4,1256,1256
Precinct,2222530083,438,383,17,1,839,839
County,Larimer,117869,92292,6477,1190,217828,217828
Precinct,2145235201,491,272,25,7,795,795
Precinct,2145235202,823,387,33,5,1248,1248
Precinct,2145235203,706,453,52,3,1214,1214
Precinct,2145235204,846,515,50,10,1421,1421
Precinct,2145235205,919,199,40,8,1166,1166
Precinct,2145235206,1216,208,33,5,1462,1462
Precinct,2145235207,851,121,24,8,1004,1004
Precinct,2145235208,1027,203,38,4,1272,1272
Precinct,2145235209,970,260,25,13,1268,1268
Precinct,2145235210,784,311,40,15,1150,1150
Precinct,2145235211,756,360,49,11,1176,1176
Precinct,2145235212,735,246,19,5,1005,1005
Precinct,2145235213,673,197,28,9,907,907
Precinct,2145235214,904,275,36,12,1227,1227
Precinct,2145235215,627,258,33,9,927,927
Precinct,2145235216,582,180,27,5,794,794
Precinct,2145235217,874,417,31,7,1329,1329
Precinct,2145235218,827,350,49,19,1245,1245
Precinct,2145235219,844,552,34,10,1440,1440
Precinct,2145235220,766,350,17,8,1141,1141
Precinct,2145235221,529,266,27,2,824,824
Precinct,2145235222,482,235,10,2,729,729
Precinct,2145235223,779,475,38,9,1301,1301
Precinct,2145235224,576,338,31,4,949,949
Precinct,2145235225,729,699,32,5,1465,1465
Precinct,2145235226,596,404,20,6,1026,1026
Precinct,2145235227,551,349,24,3,927,927
Precinct,2145235228,682,508,26,2,1218,1218
Precinct,2145235229,818,614,41,6,1479,1479
Precinct,2145235230,692,486,16,2,1196,1196
Precinct,2145235231,643,340,32,3,1018,1018
Precinct,2145235232,630,413,23,4,1070,1070
Precinct,2145235233,651,498,28,4,1181,1181
Precinct,2145235234,744,527,23,5,1299,1299
Precinct,2145235235,470,449,13,1,933,933
Precinct,2145235236,462,399,18,3,882,882
Precinct,2145235237,671,542,24,4,1241,1241
Precinct,2145235238,579,390,20,2,991,991
Precinct,2145235239,321,102,27,4,454,454
Precinct,2145235240,470,309,27,4,810,810
Precinct,2145235241,665,386,44,5,1100,1100
Precinct,2145235242,806,460,44,9,1319,1319
Precinct,2145235243,515,428,15,2,960,960
Precinct,2145235244,525,181,19,3,728,728
Precinct,2145235245,498,290,30,5,823,823
Precinct,2145235246,611,230,43,5,889,889
Precinct,2145235247,455,109,15,1,580,580
Precinct,2145235248,505,237,25,5,772,772
Precinct,2145235249,655,456,17,2,1130,1130
Precinct,2145235250,412,159,16,4,591,591
Precinct,2145235251,457,260,34,8,759,759
Precinct,2145235252,504,235,27,2,768,768
Precinct,2145335301,753,189,41,7,990,990
Precinct,2145335302,1284,199,36,11,1530,1530
Precinct,2145335303,992,159,34,7,1192,1192
Precinct,2145335304,561,189,35,9,794,794
Precinct,2145335305,946,308,56,8,1318,1318
Precinct,2145335306,443,127,33,6,609,609
Precinct,2145335307,439,122,22,8,591,591
Precinct,2145335308,544,153,40,6,743,743
Precinct,2145335309,241,73,22,3,339,339
Precinct,2145335310,582,224,27,0,833,833
Precinct,2145335311,536,166,35,5,742,742
Precinct,2145335312,895,249,49,8,1201,1201
Precinct,2145335313,814,347,34,7,1202,1202
Precinct,2145335314,747,260,32,2,1041,1041
Precinct,2145335315,839,402,45,14,1300,1300
Precinct,2145335316,616,258,27,7,908,908
Precinct,2145335317,907,372,23,4,1306,1306
Precinct,2145335318,798,338,54,11,1201,1201
Precinct,2145335319,710,363,34,3,1110,1110
Precinct,2145335320,631,278,39,3,951,951
Precinct,2145335321,801,305,30,9,1145,1145
Precinct,2145335322,855,391,38,12,1296,1296
Precinct,2145335323,796,441,46,6,1289,1289
Precinct,2145335324,929,548,30,12,1519,1519
Precinct,2145335325,944,446,44,9,1443,1443
Precinct,2145335326,563,233,31,8,835,835
Precinct,2145335327,784,485,26,3,1298,1298
Precinct,2145335328,810,521,31,3,1365,1365
Precinct,2145335329,615,472,38,5,1130,1130
Precinct,2145335330,648,546,38,3,1235,1235
Precinct,2145335331,432,359,24,9,824,824
Precinct,2145335332,543,417,35,6,1001,1001
Precinct,2145335333,497,387,18,3,905,905
Precinct,2145335334,567,156,44,3,770,770
Precinct,2145335335,161,32,19,4,216,216
Precinct,2145335336,588,162,38,7,795,795
Precinct,2145335337,682,205,48,12,947,947
Precinct,2145335338,441,155,35,5,636,636
Precinct,2145335339,554,156,30,7,747,747
Precinct,2145335340,488,266,24,0,778,778
Precinct,2145335341,475,112,31,11,629,629
Precinct,2145335342,457,204,28,8,697,697
Precinct,2145335343,554,145,33,10,742,742
Precinct,2145335344,500,178,29,8,715,715
Precinct,2154935401,282,351,18,1,652,652
Precinct,2154935402,264,500,14,3,781,781
Precinct,2154935403,363,816,27,2,1208,1208
Precinct,2154935404,29,54,4,0,87,87
Precinct,2154935405,367,321,24,1,713,713
Precinct,2154935406,434,376,20,5,835,835
Precinct,2154935407,407,303,23,9,742,742
Precinct,2154935408,349,438,25,6,818,818
Precinct,2154935409,422,688,19,7,1136,1136
Precinct,2154935410,431,491,38,2,962,962
Precinct,2154935411,706,601,22,2,1331,1331
Precinct,2154935412,446,312,12,5,775,775
Precinct,2154935413,635,531,19,2,1187,1187
Precinct,2154935414,591,441,18,8,1058,1058
Precinct,2154935415,649,501,20,3,1173,1173
Precinct,2154935416,751,483,17,1,1252,1252
Precinct,2154935417,604,475,27,2,1108,1108
Precinct,2154935418,579,889,59,7,1534,1534
Precinct,2154935419,373,622,23,2,1020,1020
Precinct,2154935420,464,476,29,7,976,976
Precinct,2154935421,397,514,28,6,945,945
Precinct,2154935422,390,652,28,5,1075,1075
Precinct,2154935423,506,903,30,1,1440,1440
Precinct,2154935424,12,29,1,0,42,42
Precinct,2154935425,54,95,4,1,154,154
Precinct,2154935426,416,555,32,5,1008,1008
Precinct,2154935427,690,545,28,0,1263,1263
Precinct,2154935428,722,426,28,5,1181,1181
Precinct,2154935429,438,439,30,6,913,913
Precinct,2154935430,363,525,22,6,916,916
Precinct,2154935431,534,758,62,9,1363,1363
Precinct,2154935432,638,849,70,5,1562,1562
Precinct,2154935433,500,757,64,10,1331,1331
Precinct,2154935434,452,765,46,5,1268,1268
Precinct,2154935435,429,650,46,8,1133,1133
Precinct,2154935436,374,518,22,4,918,918
Precinct,2154935437,373,530,22,7,932,932
Precinct,2154935438,424,505,31,1,961,961
Precinct,2154935439,351,262,21,4,638,638
Precinct,2154935440,371,462,29,4,866,866
Precinct,2154935441,501,327,22,5,855,855
Precinct,2154935442,586,681,52,7,1326,1326
Precinct,2154935443,228,391,11,3,633,633
Precinct,2154935444,261,425,29,2,717,717
Precinct,2155135501,465,557,35,5,1062,1062
Precinct,2155135502,433,693,27,4,1157,1157
Precinct,2155135503,506,781,43,9,1339,1339
Precinct,2155135504,522,669,47,14,1252,1252
Precinct,2155135505,508,562,38,12,1120,1120
Precinct,2155135506,402,567,42,8,1019,1019
Precinct,2155135507,658,868,33,3,1562,1562
Precinct,2155135508,440,519,20,4,983,983
Precinct,2155135509,386,370,21,2,779,779
Precinct,2155135510,602,593,49,8,1252,1252
Precinct,2155135511,364,430,7,3,804,804
Precinct,2155135512,622,658,56,5,1341,1341
Precinct,2155135513,459,551,39,11,1060,1060
Precinct,2155135514,572,585,46,5,1208,1208
Precinct,2155135515,506,589,32,5,1132,1132
Precinct,2155135516,662,807,22,3,1494,1494
Precinct,2155135517,573,641,37,10,1261,1261
Precinct,2155135518,643,705,49,5,1402,1402
Precinct,2155135519,510,642,45,11,1208,1208
Precinct,2155135520,561,647,38,11,1257,1257
Precinct,2155135521,530,537,27,7,1101,1101
Precinct,2155135522,686,805,36,1,1528,1528
Precinct,2155135523,460,510,18,7,995,995
Precinct,2155135524,515,602,33,11,1161,1161
Precinct,2155135525,364,462,12,2,840,840
Precinct,2155135526,634,690,28,7,1359,1359
Precinct,2155135527,499,654,31,5,1189,1189
Precinct,2155135528,734,641,49,9,1433,1433
Precinct,2155135529,532,298,35,13,878,878
Precinct,2155135530,668,623,51,9,1351,1351
Precinct,2155135531,407,519,24,2,952,952
Precinct,2155135532,613,590,40,8,1251,1251
Precinct,2155135533,462,441,39,7,949,949
Precinct,2155135534,319,341,39,6,705,705
Precinct,2155135535,558,738,57,9,1362,1362
Precinct,2155135536,605,928,47,10,1590,1590
Precinct,2155135537,626,841,39,1,1507,1507
Precinct,2155135538,522,812,33,5,1372,1372
Precinct,2155135539,569,688,32,6,1295,1295
Precinct,2155135540,262,326,29,8,625,625
Precinct,2155135541,521,892,34,7,1454,1454
Precinct,2155135542,793,705,55,10,1563,1563
Precinct,2155135543,294,382,33,1,710,710
Precinct,2155135544,450,283,34,5,772,772
Precinct,2155135545,350,440,39,10,839,839
Precinct,2155135546,369,291,33,5,698,698
Precinct,2155135547,374,357,53,9,793,793
Precinct,2155135548,277,285,22,6,590,590
Precinct,2155135549,253,341,17,2,613,613
Precinct,2155235601,268,115,9,2,394,394
Precinct,2155235602,535,280,15,1,831,831
Precinct,2155235603,783,560,21,3,1367,1367
Precinct,2155335701,869,288,32,3,1192,1192
Precinct,2155335702,653,302,31,5,991,991
Precinct,2155335703,539,379,30,15,963,963
Precinct,2234935801,423,512,18,2,955,955
Precinct,2234935802,435,496,22,5,958,958
Precinct,2234935803,408,621,21,5,1055,1055
Precinct,2234935804,587,646,35,6,1274,1274
Precinct,2234935805,263,370,9,2,644,644
Precinct,2234935806,368,534,12,0,914,914
Precinct,2234935807,279,408,8,1,696,696
Precinct,2234935808,513,878,17,0,1408,1408
Precinct,2234935809,339,878,19,4,1240,1240
Precinct,2234935810,387,633,52,4,1076,1076
Precinct,2234935811,587,998,45,8,1638,1638
Precinct,2234935812,336,608,11,2,957,957
Precinct,2234935813,318,620,12,3,953,953
Precinct,2234935814,359,482,31,4,876,876
Precinct,2234935815,365,611,14,2,992,992
Precinct,2235235101,481,293,34,11,819,819
Precinct,2235235102,112,106,0,1,219,219
County,Park,2222,3314,246,36,5818,5818
Precinct,2026047008,278,440,36,2,756,756
Precinct,2026047010,469,661,73,9,1212,1212
Precinct,2026047011,288,541,25,7,861,861
Precinct,2026047012,604,931,50,10,1595,1595
Precinct,2026047013,583,741,62,8,1394,1394
County,Summit,11677,5430,646,105,17858,17858
Precinct,2086159001,721,319,39,5,1084,1084
Precinct,2086159002,793,369,46,8,1216,1216
Precinct,2086159003,456,231,24,5,716,716
Precinct,2086159004,1007,272,37,9,1325,1325
Precinct,2086159005,818,445,49,6,1318,1318
Precinct,2086159006,444,223,25,5,697,697
Precinct,2086159007,552,257,39,10,858,858
Precinct,2086159008,287,169,26,4,486,486
Precinct,2086159009,727,344,46,15,1132,1132
Precinct,2086159010,478,284,29,3,794,794
Precinct,2086159011,396,251,21,1,669,669
Precinct,2086159012,168,140,3,3,314,314
Precinct,2086159013,600,375,36,2,1013,1013
Precinct,2086159014,401,190,26,4,621,621
Precinct,2086159015,532,288,16,1,837,837
Precinct,2086159016,515,239,29,10,793,793
Precinct,2086159017,760,261,43,4,1068,1068
Precinct,2086159018,641,217,31,4,893,893
Precinct,2086159019,697,275,34,5,1011,1011
Precinct,2086159020,684,281,47,1,1013,1013