,,Democratic,Republican,Independent,Libertarian,Green,Total Votes Cast,Total Ballots Cast
U.S. Congressperson District,2,259608,144901,16356,9749,151,430765,430765
County,Boulder,100066,22169,3895,2352,120,128602,128602
Precinct,2161307900,366,41,9,3,0,419,419
Precinct,2161307901,344,137,23,21,0,525,525
Precinct,2161307902,172,42,9,5,1,229,229
Precinct,2163307100,723,337,38,21,0,1119,1119
Precinct,2163307101,701,286,39,28,0,1054,1054
Precinct,2163307102,503,151,38,22,0,714,714
Precinct,2163307103,598,277,39,25,1,940,940
Precinct,2163307104,613,261,24,23,0,921,921
Precinct,2163307105,265,80,16,14,0,375,375
Precinct,2163307106,628,180,22,21,0,851,851
Precinct,2163307107,470,143,16,5,0,634,634
Precinct,2171207200,362,144,13,8,0,527,527
Precinct,2171207201,419,108,25,10,0,562,562
Precinct,2171207202,631,230,32,12,0,905,905
Precinct,2171207203,656,164,33,21,0,874,874
Precinct,2171207204,613,164,26,10,0,813,813
Precinct,2171207205,632,135,26,17,0,810,810
Precinct,2171207206,394,81,11,4,1,491,491
Precinct,2171207207,635,145,21,19,1,821,821
Precinct,2171207208,738,135,32,23,0,928,928
Precinct,2171207209,391,127,11,7,0,536,536
Precinct,2171207210,611,161,17,12,0,801,801
Precinct,2171207211,627,207,35,9,1,879,879
Precinct,2171207212,845,195,32,17,0,1089,1089
Precinct,2171207213,839,187,30,12,0,1068,1068
Precinct,2171207214,794,219,39,18,1,1071,1071
Precinct,2171207215,531,169,33,15,1,749,749
Precinct,2171207300,795,345,39,41,1,1221,1221
Precinct,2171207301,1039,217,61,17,1,1335,1335
Precinct,2171207302,942,266,45,24,0,1277,1277
Precinct,2171207303,565,119,31,14,1,730,730
Precinct,2171207304,585,158,24,8,0,775,775
Precinct,2171207305,670,140,27,24,2,863,863
Precinct,2171207306,727,163,47,16,0,953,953
Precinct,2171207307,439,111,28,7,0,585,585
Precinct,2171207308,611,157,30,13,1,812,812
Precinct,2171207309,674,175,48,20,0,917,917
Precinct,2171207310,830,177,49,17,0,1073,1073
Precinct,2171207311,535,104,22,12,0,673,673
Precinct,2171207312,585,217,26,9,2,839,839
Precinct,2171207313,825,218,39,15,0,1097,1097
Precinct,2171207314,957,196,32,19,0,1204,1204
Precinct,2171207315,494,172,13,9,0,688,688
Precinct,2171207316,668,311,21,17,1,1018,1018
Precinct,2171207407,187,166,14,6,0,373,373
Precinct,2173307400,54,49,5,3,0,111,111
Precinct,2173307408,589,372,34,21,1,1017,1017
Precinct,2173307409,789,389,48,39,0,1265,1265
Precinct,2173307410,549,369,24,12,0,954,954
Precinct,2173307411,643,330,42,20,1,1036,1036
Precinct,2173307412,907,421,49,33,0,1410,1410
Precinct,2173307413,630,306,55,26,0,1017,1017
Precinct,2181007500,617,89,28,21,0,755,755
Precinct,2181007501,560,210,15,5,0,790,790
Precinct,2181007502,569,285,11,11,0,876,876
Precinct,2181007503,974,269,43,22,0,1308,1308
Precinct,2181007504,488,130,16,11,1,646,646
Precinct,2181007800,526,180,7,15,0,728,728
Precinct,2181007801,555,74,20,15,3,667,667
Precinct,2181007802,617,111,30,28,0,786,786
Precinct,2181007803,666,53,28,29,1,777,777
Precinct,2181007804,879,184,26,10,1,1100,1100
Precinct,2181007805,329,69,6,10,3,417,417
Precinct,2181007806,819,129,17,21,3,989,989
Precinct,2181007807,858,97,22,15,1,993,993
Precinct,2181007808,1364,102,49,22,3,1540,1540
Precinct,2181007809,815,73,12,8,0,908,908
Precinct,2181007810,725,104,24,8,2,863,863
Precinct,2181007811,913,150,29,14,0,1106,1106
Precinct,2181007812,805,106,22,16,2,951,951
Precinct,2181007813,558,118,25,8,0,709,709
Precinct,2181007814,784,74,37,13,0,908,908
Precinct,2181007815,576,39,26,14,1,656,656
Precinct,2181007816,817,82,20,16,1,936,936
Precinct,2181007817,585,107,11,9,0,712,712
Precinct,2181007818,759,91,30,6,3,889,889
Precinct,2181007819,658,61,8,11,0,738,738
Precinct,2181007820,525,47,10,8,0,590,590
Precinct,2181007821,797,48,21,18,1,885,885
Precinct,2181007822,621,60,32,22,0,735,735
Precinct,2181007823,1155,124,54,22,4,1359,1359
Precinct,2181007824,773,73,37,17,1,901,901
Precinct,2181007825,463,46,21,6,0,536,536
Precinct,2181007826,631,46,14,6,2,699,699
Precinct,2181007827,656,46,15,6,1,724,724
Precinct,2181007828,471,43,16,6,1,537,537
Precinct,2181007829,473,37,21,16,1,548,548
Precinct,2181007830,459,26,20,20,2,527,527
Precinct,2181007831,515,35,19,11,6,586,586
Precinct,2181007832,198,31,6,6,1,242,242
Precinct,2181007833,408,50,10,20,1,489,489
Precinct,2181007834,414,102,22,21,0,559,559
Precinct,2181007835,263,35,16,8,0,322,322
Precinct,2181007836,335,50,9,6,0,400,400
Precinct,2181007837,537,64,23,23,0,647,647
Precinct,2181007838,267,29,14,15,0,325,325
Precinct,2181007839,443,68,14,10,0,535,535
Precinct,2181007840,422,69,13,6,0,510,510
Precinct,2181007841,394,76,8,6,0,484,484
Precinct,2181007842,755,142,25,12,0,934,934
Precinct,2181007843,927,137,28,13,1,1106,1106
Precinct,2181007844,502,44,16,11,1,574,574
Precinct,2181007845,603,44,29,19,1,696,696
Precinct,2181007846,647,102,33,28,0,810,810
Precinct,2181007847,416,62,22,15,1,516,516
Precinct,2181007848,463,30,21,6,1,521,521
Precinct,2181007849,358,48,17,13,0,436,436
Precinct,2181007850,433,128,9,8,2,580,580
Precinct,2181007851,700,112,18,5,2,837,837
Precinct,2181007852,728,111,26,14,0,879,879
Precinct,2181007853,567,63,18,12,0,660,660
Precinct,2181107505,547,154,18,9,0,728,728
Precinct,2181107506,305,167,7,8,0,487,487
Precinct,2181107507,560,382,17,23,0,982,982
Precinct,2181107508,505,129,17,8,0,659,659
Precinct,2181107700,550,210,27,8,1,796,796
Precinct,2181107701,306,161,21,12,0,500,500
Precinct,2181107702,168,131,10,2,0,311,311
Precinct,2181107703,246,141,10,4,0,401,401
Precinct,2181107704,189,90,8,6,0,293,293
Precinct,2181107705,296,213,14,12,1,536,536
Precinct,2181107912,761,194,21,18,2,996,996
Precinct,2181107913,440,117,13,8,1,579,579
Precinct,2181107916,231,137,7,7,1,383,383
Precinct,2181107917,814,259,46,23,0,1142,1142
Precinct,2181107918,724,204,31,24,1,984,984
Precinct,2181207401,391,180,17,7,1,596,596
Precinct,2181207402,378,135,14,18,0,545,545
Precinct,2181207403,621,134,33,9,0,797,797
Precinct,2181207404,570,206,20,27,0,823,823
Precinct,2181207405,270,126,6,9,1,412,412
Precinct,2181207406,325,235,14,10,0,584,584
Precinct,2181307854,646,52,23,14,2,737,737
Precinct,2181307855,574,62,24,14,0,674,674
Precinct,2181307856,463,40,28,6,0,537,537
Precinct,2181307857,593,111,12,14,0,730,730
Precinct,2181307858,708,79,24,13,3,827,827
Precinct,2181307859,643,71,11,8,0,733,733
Precinct,2181307860,478,61,7,8,1,555,555
Precinct,2181307861,464,59,9,4,1,537,537
Precinct,2181307862,510,34,14,9,0,567,567
Precinct,2181307863,587,81,12,7,3,690,690
Precinct,2181307864,470,72,15,4,0,561,561
Precinct,2181307865,447,50,16,8,0,521,521
Precinct,2181307866,653,51,19,10,0,733,733
Precinct,2181307867,582,41,34,17,0,674,674
Precinct,2181307868,646,97,28,14,2,787,787
Precinct,2181307869,440,49,8,7,0,504,504
Precinct,2181307870,433,45,22,14,1,515,515
Precinct,2181307871,557,35,26,14,1,633,633
Precinct,2181307872,389,67,19,17,0,492,492
Precinct,2181307873,320,62,9,5,0,396,396
Precinct,2181307874,732,83,13,9,0,837,837
Precinct,2181307875,257,53,15,10,3,338,338
Precinct,2181307876,326,59,10,11,0,406,406
Precinct,2181307877,489,67,6,12,1,575,575
Precinct,2181307878,469,38,8,17,0,532,532
Precinct,2181307879,463,34,22,12,0,531,531
Precinct,2181307880,437,81,19,11,0,548,548
Precinct,2181307881,455,59,7,4,1,526,526
Precinct,2181307882,478,60,4,2,2,546,546
Precinct,2181307883,638,40,10,7,3,698,698
Precinct,2181307884,639,40,20,13,1,713,713
Precinct,2181307885,488,35,7,7,0,537,537
Precinct,2181307886,613,68,17,7,1,706,706
Precinct,2181307887,702,97,17,13,2,831,831
Precinct,2181307888,621,115,8,3,0,747,747
Precinct,2181307903,1229,202,57,40,4,1532,1532
Precinct,2181307904,356,41,17,7,0,421,421
Precinct,2181307905,177,51,6,3,0,237,237
Precinct,2181307906,346,97,15,4,0,462,462
Precinct,2181307908,660,133,23,8,1,825,825
Precinct,2181307909,413,44,13,11,1,482,482
Precinct,2181307910,488,109,22,9,1,629,629
Precinct,2181307911,640,132,22,14,0,808,808
Precinct,2181307914,400,75,16,12,1,504,504
Precinct,2181307915,225,63,9,10,2,309,309
County,Broomfield,20290,13019,1564,776,3,35652,35652
Precinct,2233364001,558,296,36,16,0,906,906
Precinct,2233364002,885,317,79,42,0,1323,1323
Precinct,2233364003,663,229,37,23,0,952,952
Precinct,2233364004,790,409,63,21,0,1283,1283
Precinct,2233364005,34,10,1,1,0,46,46
Precinct,2233364006,971,298,79,61,0,1409,1409
Precinct,2233364007,381,164,32,21,0,598,598
Precinct,2233364008,265,186,32,7,0,490,490
Precinct,2233364009,391,191,34,10,0,626,626
Precinct,2233364010,481,378,37,18,0,914,914
Precinct,2233364011,471,325,34,19,0,849,849
Precinct,2233364012,511,435,38,15,0,999,999
Precinct,2233364013,419,206,35,23,0,683,683
Precinct,2233364014,462,267,37,20,2,788,788
Precinct,2233364015,484,345,36,19,0,884,884
Precinct,2233364016,443,474,28,12,0,957,957
Precinct,2233364017,592,577,26,23,0,1218,1218
Precinct,2233364018,372,221,33,14,0,640,640
Precinct,2233364019,469,337,43,35,0,884,884
Precinct,2233364020,365,297,43,19,0,724,724
Precinct,2233364021,818,430,86,40,0,1374,1374
Precinct,2233364022,549,346,30,23,0,948,948
Precinct,2233364023,515,310,32,11,0,868,868
Precinct,2233364024,867,634,60,27,0,1588,1588
Precinct,2233364025,829,610,53,34,0,1526,1526
Precinct,2233364026,498,384,42,20,0,944,944
Precinct,2233364027,652,365,52,25,0,1094,1094
Precinct,2233364028,140,94,30,7,0,271,271
Precinct,2233364029,465,327,45,24,0,861,861
Precinct,2233364030,422,295,57,19,0,793,793
Precinct,2233364031,364,283,45,22,1,715,715
Precinct,2233364032,934,605,58,34,0,1631,1631
Precinct,2233364033,781,453,45,13,0,1292,1292
Precinct,2233364034,146,306,8,8,0,468,468
Precinct,2233364035,1085,724,41,10,0,1860,1860
Precinct,2233364036,981,714,77,28,0,1800,1800
Precinct,2233364037,237,177,20,12,0,446,446
County,Clear Creek,2847,2062,253,156,1,5319,5319
Precinct,2021310001,459,218,37,15,0,729,729
Precinct,2021310002,133,90,9,7,0,239,239
Precinct,2021310003,161,115,23,5,0,304,304
Precinct,2021310004,327,221,40,30,0,618,618
Precinct,2021310005,315,218,32,28,1,594,594
Precinct,2021310006,206,125,21,16,0,368,368
Precinct,2021310007,470,410,42,27,0,949,949
Precinct,2021310008,327,245,19,7,0,598,598
Precinct,2021310009,449,420,30,21,0,920,920
County,Eagle,3641,1527,238,142,0,5548,5548
Precinct,2052619001,84,23,8,2,0,117,117
Precinct,2052619002,343,149,27,18,0,537,537
Precinct,2052619003,368,113,18,18,0,517,517
Precinct,2052619011,294,101,21,15,0,431,431
Precinct,2052619012,604,255,38,25,0,922,922
Precinct,2052619013,387,224,24,15,0,650,650
Precinct,2052619014,305,136,20,9,0,470,470
Precinct,2052619015,606,245,50,19,0,920,920
Precinct,2052619019,650,281,32,21,0,984,984
County,Gilpin,1732,1304,198,107,4,3345,3345
Precinct,2161324001,220,199,40,15,0,474,474
Precinct,2161324002,239,297,23,25,0,584,584
Precinct,2161324003,302,320,44,13,0,679,679
Precinct,2161324004,273,182,28,16,1,500,500
Precinct,2161324005,275,168,26,11,1,481,481
Precinct,2161324006,423,138,37,27,2,627,627
County,Grand,3328,3609,432,222,0,7591,7591
Precinct,2081325001,236,270,19,11,0,536,536
Precinct,2081325002,296,502,61,29,0,888,888
Precinct,2081325003,430,537,63,34,0,1064,1064
Precinct,2081325004,114,332,30,12,0,488,488
Precinct,2081325005,182,443,47,21,0,693,693
Precinct,2081325006,299,130,30,16,0,475,475
Precinct,2081325007,436,213,30,19,0,698,698
Precinct,2081325008,156,317,36,19,0,528,528
Precinct,2081325009,322,135,34,19,0,510,510
Precinct,2081325010,239,277,26,14,0,556,556
Precinct,2081325011,267,158,27,12,0,464,464
Precinct,2081325012,351,295,29,16,0,691,691
County,Jefferson,24426,22005,1698,1185,5,49319,49319
Precinct,2162530036,750,596,69,41,2,1458,1458
Precinct,2162530037,589,346,22,18,0,975,975
Precinct,2162530038,598,370,30,33,0,1031,1031
Precinct,2162530039,501,572,32,21,0,1126,1126
Precinct,2162530040,672,698,32,16,0,1418,1418
Precinct,2162530041,445,389,18,17,0,869,869
Precinct,2162530042,515,461,29,13,0,1018,1018
Precinct,2162530043,348,311,28,28,0,715,715
Precinct,2162530044,483,308,27,31,0,849,849
Precinct,2162530045,527,333,22,24,0,906,906
Precinct,2162530046,532,306,41,25,0,904,904
Precinct,2162530047,541,411,20,12,0,984,984
Precinct,2162530048,629,389,38,30,0,1086,1086
Precinct,2162530049,494,418,32,19,0,963,963
Precinct,2162530050,464,440,24,29,0,957,957
Precinct,2162530051,685,388,33,37,0,1143,1143
Precinct,2162530052,599,428,31,22,1,1081,1081
Precinct,2162530053,420,364,26,33,0,843,843
Precinct,2162530054,545,443,20,17,0,1025,1025
Precinct,2162530055,294,186,20,12,0,512,512
Precinct,2162530056,395,414,22,15,0,846,846
Precinct,2162530057,472,474,41,29,0,1016,1016
Precinct,2162530058,650,680,41,29,0,1400,1400
Precinct,2162530059,464,479,35,36,0,1014,1014
Precinct,2162530060,224,238,19,9,0,490,490
Precinct,2162530061,505,473,41,31,0,1050,1050
Precinct,2162530062,514,554,46,40,0,1154,1154
Precinct,2162530063,422,394,23,29,1,869,869
Precinct,2162530064,207,302,12,10,0,531,531
Precinct,2162530065,508,584,52,24,0,1168,1168
Precinct,2162530066,500,528,28,24,0,1080,1080
Precinct,2162530067,458,418,56,30,1,963,963
Precinct,2162530068,315,464,21,19,0,819,819
Precinct,2202230069,251,163,21,24,0,459,459
Precinct,2202530070,703,551,69,40,0,1363,1363
Precinct,2202530071,588,605,62,33,0,1288,1288
Precinct,2202530072,682,514,73,42,0,1311,1311
Precinct,2202530073,678,592,60,19,0,1349,1349
Precinct,2202530074,622,642,51,24,0,1339,1339
Precinct,2202530075,668,633,49,36,0,1386,1386
Precinct,2202530076,591,587,49,28,0,1255,1255
Precinct,2202530077,557,739,35,25,0,1356,1356
Precinct,2202530078,624,510,23,18,0,1175,1175
Precinct,2202530079,375,305,22,19,0,721,721
Precinct,2202530080,399,560,23,21,0,1003,1003
Precinct,2222230081,583,572,49,25,0,1229,1229
Precinct,2222230082,465,514,62,13,0,1054,1054
Precinct,2222530083,375,359,19,15,0,768,768
County,Larimer,92787,72558,7113,4330,15,176803,176803
Precinct,2145235201,350,203,22,13,0,588,588
Precinct,2145235202,649,282,36,27,0,994,994
Precinct,2145235203,557,338,46,32,0,973,973
Precinct,2145235204,636,339,52,37,0,1064,1064
Precinct,2145235205,749,137,41,26,0,953,953
Precinct,2145235206,1004,175,35,39,0,1253,1253
Precinct,2145235207,765,115,35,21,0,936,936
Precinct,2145235208,834,187,56,26,1,1104,1104
Precinct,2145235209,841,214,43,25,0,1123,1123
Precinct,2145235210,587,205,39,29,0,860,860
Precinct,2145235211,594,285,30,27,0,936,936
Precinct,2145235212,605,238,30,24,0,897,897
Precinct,2145235213,518,174,28,26,0,746,746
Precinct,2145235214,760,216,23,25,0,1024,1024
Precinct,2145235215,473,202,41,23,0,739,739
Precinct,2145235216,503,135,26,13,0,677,677
Precinct,2145235217,771,372,27,21,0,1191,1191
Precinct,2145235218,638,279,40,30,0,987,987
Precinct,2145235219,652,512,45,24,0,1233,1233
Precinct,2145235220,633,341,26,18,0,1018,1018
Precinct,2145235221,632,318,71,30,0,1051,1051
Precinct,2145235222,424,219,27,7,0,677,677
Precinct,2145235223,603,390,32,22,0,1047,1047
Precinct,2145235224,441,252,39,28,0,760,760
Precinct,2145235225,577,638,32,32,0,1279,1279
Precinct,2145235226,468,283,37,19,0,807,807
Precinct,2145235227,433,262,21,15,0,731,731
Precinct,2145235228,552,430,27,17,0,1026,1026
Precinct,2145235229,631,533,23,21,0,1208,1208
Precinct,2145235230,558,416,30,16,0,1020,1020
Precinct,2145235231,549,293,35,11,0,888,888
Precinct,2145235232,553,383,15,9,1,961,961
Precinct,2145235233,525,403,25,18,0,971,971
Precinct,2145235234,638,462,33,24,0,1157,1157
Precinct,2145235235,745,607,29,20,0,1401,1401
Precinct,2145235236,363,362,14,10,0,749,749
Precinct,2145235237,555,479,21,26,0,1081,1081
Precinct,2145235238,478,337,36,15,0,866,866
Precinct,2145235239,723,271,62,41,0,1097,1097
Precinct,2145235240,668,344,47,28,0,1087,1087
Precinct,2145235241,517,303,24,30,0,874,874
Precinct,2145235242,361,231,22,16,0,630,630
Precinct,2145235243,415,357,29,13,0,814,814
Precinct,2145235244,430,150,34,14,0,628,628
Precinct,2145235245,391,242,19,18,0,670,670
Precinct,2145235246,445,169,21,24,0,659,659
Precinct,2145235247,370,72,13,16,0,471,471
Precinct,2145335301,628,150,29,20,0,827,827
Precinct,2145335302,1165,145,44,31,0,1385,1385
Precinct,2145335303,829,136,45,20,0,1030,1030
Precinct,2145335304,472,136,30,25,0,663,663
Precinct,2145335305,731,256,55,35,0,1077,1077
Precinct,2145335306,372,109,31,19,0,531,531
Precinct,2145335307,416,92,36,18,0,562,562
Precinct,2145335308,404,126,35,29,0,594,594
Precinct,2145335309,504,127,32,23,0,686,686
Precinct,2145335310,439,208,24,18,0,689,689
Precinct,2145335311,466,157,31,12,0,666,666
Precinct,2145335312,766,210,44,29,0,1049,1049
Precinct,2145335313,697,272,41,25,0,1035,1035
Precinct,2145335314,591,232,27,30,0,880,880
Precinct,2145335315,712,335,57,26,0,1130,1130
Precinct,2145335316,532,229,34,19,0,814,814
Precinct,2145335317,791,345,37,26,0,1199,1199
Precinct,2145335318,616,232,58,36,0,942,942
Precinct,2145335319,550,313,36,18,0,917,917
Precinct,2145335320,513,226,32,22,0,793,793
Precinct,2145335321,591,189,26,24,0,830,830
Precinct,2145335322,616,332,47,33,0,1028,1028
Precinct,2145335323,610,343,42,23,0,1018,1018
Precinct,2145335324,818,476,40,28,0,1362,1362
Precinct,2145335325,785,348,41,38,0,1212,1212
Precinct,2145335326,440,187,32,14,0,673,673
Precinct,2145335327,658,461,31,23,0,1173,1173
Precinct,2145335328,698,480,31,17,0,1226,1226
Precinct,2145335329,473,423,25,23,0,944,944
Precinct,2145335330,509,490,35,29,0,1063,1063
Precinct,2145335331,323,262,28,8,0,621,621
Precinct,2145335332,428,350,42,27,0,847,847
Precinct,2145335333,409,310,25,13,1,758,758
Precinct,2145335334,631,116,42,25,0,814,814
Precinct,2145335335,347,81,13,16,0,457,457
Precinct,2145335336,481,112,36,23,0,652,652
Precinct,2145335337,505,137,43,24,0,709,709
Precinct,2145335338,486,133,32,24,0,675,675
Precinct,2145335339,456,112,30,19,0,617,617
Precinct,2145335340,402,205,21,17,0,645,645
Precinct,2145335341,462,83,26,15,1,587,587
Precinct,2145335342,367,175,22,18,0,582,582
Precinct,2145335343,421,117,32,18,0,588,588
Precinct,2145335344,399,139,34,26,0,598,598
Precinct,2154935401,234,296,23,9,0,562,562
Precinct,2154935402,223,387,29,19,0,658,658
Precinct,2154935403,288,606,33,16,0,943,943
Precinct,2154935404,25,44,2,3,0,74,74
Precinct,2154935405,323,239,15,18,0,595,595
Precinct,2154935406,394,329,24,15,0,762,762
Precinct,2154935407,344,239,20,13,0,616,616
Precinct,2154935408,309,363,29,14,0,715,715
Precinct,2154935409,328,592,39,28,0,987,987
Precinct,2154935410,341,379,30,24,0,774,774
Precinct,2154935411,576,509,39,18,0,1142,1142
Precinct,2154935412,388,274,35,11,1,709,709
Precinct,2154935413,521,463,28,20,0,1032,1032
Precinct,2154935414,468,401,37,14,0,920,920
Precinct,2154935415,520,433,29,22,0,1004,1004
Precinct,2154935416,627,446,27,6,0,1106,1106
Precinct,2154935417,533,403,32,15,2,985,985
Precinct,2154935418,474,714,48,43,0,1279,1279
Precinct,2154935419,650,920,72,46,0,1688,1688
Precinct,2154935420,366,401,34,19,0,820,820
Precinct,2154935421,295,415,39,13,0,762,762
Precinct,2154935422,418,719,54,42,0,1233,1233
Precinct,2154935423,405,750,36,24,0,1215,1215
Precinct,2154935424,11,20,1,0,0,32,32
Precinct,2154935425,50,83,5,2,0,140,140
Precinct,2154935426,349,501,31,24,0,905,905
Precinct,2154935427,594,484,31,24,0,1133,1133
Precinct,2154935428,622,319,19,19,0,979,979
Precinct,2154935429,389,341,43,14,0,787,787
Precinct,2154935430,309,429,30,15,0,783,783
Precinct,2154935431,348,517,44,34,1,944,944
Precinct,2154935432,465,608,64,37,0,1174,1174
Precinct,2154935433,364,550,68,30,0,1012,1012
Precinct,2154935434,279,469,44,21,0,813,813
Precinct,2154935435,322,435,32,15,0,804,804
Precinct,2154935436,285,333,31,20,0,669,669
Precinct,2154935437,292,443,32,10,1,778,778
Precinct,2154935438,353,402,28,31,0,814,814
Precinct,2154935439,295,223,37,16,0,571,571
Precinct,2154935440,272,288,26,18,0,604,604
Precinct,2154935441,429,272,26,10,0,737,737
Precinct,2155135501,267,352,42,15,0,676,676
Precinct,2155135502,351,584,35,22,0,992,992
Precinct,2155135503,374,585,37,31,0,1027,1027
Precinct,2155135504,412,483,46,14,0,955,955
Precinct,2155135505,338,363,48,40,0,789,789
Precinct,2155135506,314,438,46,24,0,822,822
Precinct,2155135507,517,754,51,22,0,1344,1344
Precinct,2155135508,332,404,24,24,0,784,784
Precinct,2155135509,280,300,33,19,0,632,632
Precinct,2155135510,453,486,40,23,0,1002,1002
Precinct,2155135511,290,412,22,10,0,734,734
Precinct,2155135512,458,537,60,33,0,1088,1088
Precinct,2155135513,354,412,62,31,0,859,859
Precinct,2155135514,445,466,63,30,0,1004,1004
Precinct,2155135515,368,493,48,7,0,916,916
Precinct,2155135516,537,719,40,15,0,1311,1311
Precinct,2155135517,437,534,43,27,2,1043,1043
Precinct,2155135518,454,567,47,41,1,1110,1110
Precinct,2155135519,387,506,50,28,0,971,971
Precinct,2155135520,442,520,58,24,0,1044,1044
Precinct,2155135521,427,469,39,24,0,959,959
Precinct,2155135522,551,696,49,31,1,1328,1328
Precinct,2155135523,380,464,30,13,0,887,887
Precinct,2155135524,372,475,42,21,0,910,910
Precinct,2155135525,263,381,12,8,0,664,664
Precinct,2155135526,501,576,39,36,1,1153,1153
Precinct,2155135527,384,516,58,18,0,976,976
Precinct,2155135528,579,481,73,35,0,1168,1168
Precinct,2155135529,368,223,44,23,0,658,658
Precinct,2155135530,499,477,58,30,1,1065,1065
Precinct,2155135531,310,403,26,18,0,757,757
Precinct,2155135532,475,438,60,23,0,996,996
Precinct,2155135533,334,330,46,15,0,725,725
Precinct,2155135534,228,249,37,19,0,533,533
Precinct,2155135535,406,550,71,40,0,1067,1067
Precinct,2155135536,497,733,65,32,0,1327,1327
Precinct,2155135537,514,696,52,33,0,1295,1295
Precinct,2155135538,429,689,36,35,0,1189,1189
Precinct,2155135539,431,573,39,15,0,1058,1058
Precinct,2155135540,189,249,22,27,0,487,487
Precinct,2155135541,418,739,47,20,0,1224,1224
Precinct,2155135542,456,378,43,36,0,913,913
Precinct,2155135543,192,315,35,17,0,559,559
Precinct,2155135544,340,239,32,15,0,626,626
Precinct,2155135545,278,359,28,19,0,684,684
Precinct,2155135546,295,204,33,17,0,549,549
Precinct,2155135547,261,283,41,25,0,610,610
Precinct,2155135548,240,211,24,11,0,486,486
Precinct,2155135549,189,286,26,10,0,511,511
Precinct,2155235601,196,80,14,11,0,301,301
Precinct,2155235602,495,246,21,15,0,777,777
Precinct,2155235603,665,529,23,21,0,1238,1238
Precinct,2155335701,694,231,49,31,0,1005,1005
Precinct,2155335702,557,263,26,18,0,864,864
Precinct,2155335703,369,254,42,15,0,680,680
Precinct,2234935801,329,387,32,23,0,771,771
Precinct,2234935802,282,365,10,9,0,666,666
Precinct,2234935803,419,758,45,18,0,1240,1240
Precinct,2234935804,269,349,18,13,0,649,649
Precinct,2234935805,230,316,18,14,0,578,578
Precinct,2234935806,287,447,25,16,0,775,775
Precinct,2234935807,224,364,23,9,0,620,620
Precinct,2234935808,357,725,24,12,0,1118,1118
Precinct,2234935809,213,657,28,10,0,908,908
Precinct,2234935810,248,446,32,18,0,744,744
Precinct,2234935811,308,584,39,29,0,960,960
Precinct,2234935812,261,515,30,8,0,814,814
Precinct,2234935813,267,501,30,14,0,812,812
Precinct,2234935814,276,353,25,16,0,670,670
Precinct,2235235101,371,208,33,19,0,631,631
Precinct,2235235102,103,92,5,1,0,201,201
County,Park,1656,2580,263,125,2,4626,4626
Precinct,2026047008,211,326,43,18,0,598,598
Precinct,2026047010,344,481,58,33,0,916,916
Precinct,2026047011,213,452,30,14,0,709,709
Precinct,2026047012,436,725,70,30,0,1261,1261
Precinct,2026047013,452,596,62,30,2,1142,1142
County,Summit,8835,4068,702,354,1,13960,13960
Precinct,2086159001,551,208,38,22,0,819,819
Precinct,2086159002,578,268,55,24,0,925,925
Precinct,2086159003,353,173,14,17,0,557,557
Precinct,2086159004,795,190,56,29,0,1070,1070
Precinct,2086159005,632,342,40,29,0,1043,1043
Precinct,2086159006,333,185,28,11,0,557,557
Precinct,2086159007,354,197,32,12,0,595,595
Precinct,2086159008,199,150,17,13,0,379,379
Precinct,2086159009,557,250,56,30,0,893,893
Precinct,2086159010,408,216,42,20,0,686,686
Precinct,2086159011,311,183,25,17,0,536,536
Precinct,2086159012,123,114,8,1,0,246,246
Precinct,2086159013,435,337,27,12,0,811,811
Precinct,2086159014,311,120,31,16,0,478,478
Precinct,2086159015,399,199,27,18,0,643,643
Precinct,2086159016,404,179,35,17,0,635,635
Precinct,2086159017,577,207,47,10,1,842,842
Precinct,2086159018,562,138,32,23,0,755,755
Precinct,2086159019,520,228,52,17,0,817,817
Precinct,2086159020,433,184,40,16,0,673,673