,,Democratic,Republican,Libertarian,Colorado Center,Total Votes Cast,Total Ballots Cast
U.S. Congressperson District,8,114377,112745,9280,99,236501,236501
County,Adams,78113,57856,5684,61,141714,141714
Precinct,8134801162,260,505,17,0,782,782
Precinct,8134801163,135,341,11,0,487,487
Precinct,8134801170,371,281,46,0,698,698
Precinct,8134801171,395,368,46,0,809,809
Precinct,8134801172,65,86,12,0,163,163
Precinct,8134801173,30,39,0,0,69,69
Precinct,8134801174,116,209,15,0,340,340
Precinct,8134801175,345,463,42,0,850,850
Precinct,8134801176,166,217,18,0,401,401
Precinct,8134801177,135,227,13,0,375,375
Precinct,8134801178,130,139,7,0,276,276
Precinct,8134801179,96,109,14,0,219,219
Precinct,8134801180,247,361,28,0,636,636
Precinct,8134801181,358,378,38,0,774,774
Precinct,8134801182,215,259,22,0,496,496
Precinct,8134801183,85,145,17,0,247,247
Precinct,8134801184,94,123,12,0,229,229
Precinct,8134801185,160,244,8,0,412,412
Precinct,8134801186,310,418,26,2,756,756
Precinct,8134801187,242,316,36,0,594,594
Precinct,8134801188,218,314,22,0,554,554
Precinct,8134801189,224,333,16,0,573,573
Precinct,8134801190,323,375,30,0,728,728
Precinct,8134801191,406,371,51,0,828,828
Precinct,8134801192,234,183,38,0,455,455
Precinct,8134801193,297,281,30,0,608,608
Precinct,8134801194,100,142,14,0,256,256
Precinct,8134801195,159,168,9,0,336,336
Precinct,8134801196,110,133,3,0,246,246
Precinct,8134801197,86,72,5,0,163,163
Precinct,8134801198,281,435,27,0,743,743
Precinct,8134801227,87,172,10,0,269,269
Precinct,8213201003,0,0,0,0,0,0
Precinct,8213201117,519,277,47,0,843,843
Precinct,8213201118,301,168,33,0,502,502
Precinct,8213201119,410,192,49,1,652,652
Precinct,8213201120,448,195,25,1,669,669
Precinct,8213201121,336,209,28,0,573,573
Precinct,8213201122,215,122,18,0,355,355
Precinct,8213201123,344,174,42,0,560,560
Precinct,8213201124,382,144,32,0,558,558
Precinct,8213201125,253,138,27,0,418,418
Precinct,8213201126,399,243,40,0,682,682
Precinct,8213201127,278,160,32,0,470,470
Precinct,8213201128,325,170,23,0,518,518
Precinct,8213201129,339,207,33,0,579,579
Precinct,8213201140,214,134,12,0,360,360
Precinct,8213201141,427,288,42,0,757,757
Precinct,8213201199,194,256,17,0,467,467
Precinct,8213201200,19,49,4,0,72,72
Precinct,8213201201,225,193,28,2,448,448
Precinct,8213201202,187,189,8,0,384,384
Precinct,8213201203,284,289,22,0,595,595
Precinct,8213201204,210,165,15,0,390,390
Precinct,8213201205,370,394,31,0,795,795
Precinct,8213201206,356,430,39,0,825,825
Precinct,8213201207,217,197,20,0,434,434
Precinct,8213201208,151,113,11,0,275,275
Precinct,8213201209,355,219,20,0,594,594
Precinct,8213201210,414,343,27,0,784,784
Precinct,8213201211,110,109,14,0,233,233
Precinct,8213201212,350,307,19,2,678,678
Precinct,8213201213,379,227,31,0,637,637
Precinct,8213201214,374,266,28,0,668,668
Precinct,8213201215,325,381,23,0,729,729
Precinct,8213201216,480,347,37,1,865,865
Precinct,8213201217,282,213,22,0,517,517
Precinct,8213201218,308,256,23,0,587,587
Precinct,8213201219,296,170,14,0,480,480
Precinct,8213201220,162,107,7,0,276,276
Precinct,8213201221,189,119,17,0,325,325
Precinct,8213201222,217,141,9,0,367,367
Precinct,8213201223,37,20,5,0,62,62
Precinct,8213201224,21,19,1,0,41,41
Precinct,8213201225,30,53,5,0,88,88
Precinct,8213201254,220,120,20,0,360,360
Precinct,8213201255,145,96,22,0,263,263
Precinct,8213201261,185,173,13,1,372,372
Precinct,8213201276,136,66,14,1,217,217
Precinct,8213501001,490,137,42,0,669,669
Precinct,8213501002,280,104,12,0,396,396
Precinct,8213501004,289,159,22,0,470,470
Precinct,8213501005,548,221,39,0,808,808
Precinct,8213501006,372,125,28,0,525,525
Precinct,8213501007,480,254,24,1,759,759
Precinct,8213501010,468,234,41,0,743,743
Precinct,8213501011,228,88,17,0,333,333
Precinct,8213501012,407,227,28,0,662,662
Precinct,8213501013,616,297,55,3,971,971
Precinct,8213501014,379,222,25,0,626,626
Precinct,8213501017,263,155,15,0,433,433
Precinct,8213501018,278,163,22,0,463,463
Precinct,8213501019,260,135,20,0,415,415
Precinct,8213501020,412,155,23,0,590,590
Precinct,8213501021,454,212,38,0,704,704
Precinct,8213501022,444,241,42,0,727,727
Precinct,8213501023,329,160,21,2,512,512
Precinct,8213501024,450,206,37,0,693,693
Precinct,8213501025,425,227,39,0,691,691
Precinct,8213501026,178,71,17,0,266,266
Precinct,8213501257,666,163,27,1,857,857
Precinct,8213501262,343,160,33,0,536,536
Precinct,8213501270,456,159,17,0,632,632
Precinct,8213501271,395,129,35,0,559,559
Precinct,8213501275,454,188,48,0,690,690
Precinct,8214801226,45,155,4,1,205,205
Precinct,8215601228,173,338,20,0,531,531
Precinct,8215601268,15,41,2,0,58,58
Precinct,8243101028,336,145,33,0,514,514
Precinct,8243101029,400,169,30,0,599,599
Precinct,8243101037,219,112,15,0,346,346
Precinct,8243101038,432,294,35,2,763,763
Precinct,8243101041,374,184,17,0,575,575
Precinct,8243101097,222,182,15,0,419,419
Precinct,8243101103,168,81,17,0,266,266
Precinct,8243101105,46,25,5,0,76,76
Precinct,8243101106,503,286,27,0,816,816
Precinct,8243101107,507,283,23,1,814,814
Precinct,8243101108,453,282,38,0,773,773
Precinct,8243101109,459,269,31,0,759,759
Precinct,8243101110,319,167,31,0,517,517
Precinct,8243101111,367,256,25,0,648,648
Precinct,8243101112,359,145,20,0,524,524
Precinct,8243101113,387,214,34,0,635,635
Precinct,8243101114,350,172,18,0,540,540
Precinct,8243101115,346,188,22,0,556,556
Precinct,8243101116,185,127,24,0,336,336
Precinct,8243101131,197,133,12,0,342,342
Precinct,8243101132,346,184,25,0,555,555
Precinct,8243101133,440,332,30,0,802,802
Precinct,8243101134,416,318,30,0,764,764
Precinct,8243101135,496,383,53,1,933,933
Precinct,8243101136,329,300,32,0,661,661
Precinct,8243101137,529,414,36,1,980,980
Precinct,8243101138,314,300,17,0,631,631
Precinct,8243101139,156,108,2,0,266,266
Precinct,8243101142,395,429,21,0,845,845
Precinct,8243101143,349,220,23,0,592,592
Precinct,8243101144,475,343,46,0,864,864
Precinct,8243101145,540,346,40,1,927,927
Precinct,8243101146,190,117,12,1,320,320
Precinct,8243101147,594,399,34,0,1027,1027
Precinct,8243101148,316,254,21,0,591,591
Precinct,8243101250,207,78,22,0,307,307
Precinct,8243101263,233,100,12,0,345,345
Precinct,8243101274,0,0,0,0,0,0
Precinct,8243201130,54,45,9,0,108,108
Precinct,8243301071,280,292,29,0,601,601
Precinct,8243301072,371,316,21,0,708,708
Precinct,8243301073,377,375,32,1,785,785
Precinct,8243301074,348,379,27,0,754,754
Precinct,8243301075,225,194,18,0,437,437
Precinct,8243301158,457,383,25,0,865,865
Precinct,8243301160,457,458,27,0,942,942
Precinct,8243301161,235,321,4,0,560,560
Precinct,8243301165,610,758,23,0,1391,1391
Precinct,8243301259,57,110,3,0,170,170
Precinct,8243401076,472,364,23,0,859,859
Precinct,8243401077,213,204,13,0,430,430
Precinct,8243401078,299,218,15,1,533,533
Precinct,8243401079,320,267,6,0,593,593
Precinct,8243401080,332,365,25,0,722,722
Precinct,8243401081,362,293,16,0,671,671
Precinct,8243401082,424,292,23,0,739,739
Precinct,8243401083,395,312,21,0,728,728
Precinct,8243401084,249,241,12,0,502,502
Precinct,8243401085,457,317,30,1,805,805
Precinct,8243401086,364,354,26,1,745,745
Precinct,8243401087,266,188,21,1,476,476
Precinct,8243401088,525,373,27,0,925,925
Precinct,8243401089,395,268,26,0,689,689
Precinct,8243401093,437,371,25,0,833,833
Precinct,8243401094,406,382,32,0,820,820
Precinct,8243401149,375,353,37,0,765,765
Precinct,8243401150,580,397,47,1,1025,1025
Precinct,8243401151,478,379,24,0,881,881
Precinct,8243401152,437,387,40,1,865,865
Precinct,8243401153,273,306,14,0,593,593
Precinct,8243401155,360,370,29,0,759,759
Precinct,8243401156,335,310,19,0,664,664
Precinct,8243401157,342,303,20,1,666,666
Precinct,8243401159,313,251,16,0,580,580
Precinct,8243401252,526,413,25,0,964,964
Precinct,8243401256,458,453,29,0,940,940
Precinct,8243401264,156,144,12,0,312,312
Precinct,8243401265,151,93,10,0,254,254
Precinct,8243501027,229,92,8,0,329,329
Precinct,8243501030,242,183,47,0,472,472
Precinct,8243501035,226,130,27,0,383,383
Precinct,8243501036,278,245,55,0,578,578
Precinct,8243501042,312,180,26,1,519,519
Precinct,8244801154,6,22,0,0,28,28
Precinct,8244801164,99,202,8,0,309,309
Precinct,8244801166,121,241,15,0,377,377
Precinct,8244801167,154,287,8,0,449,449
Precinct,8244801168,23,53,3,0,79,79
Precinct,8244801169,96,208,10,1,315,315
Precinct,8252901032,260,151,25,0,436,436
Precinct,8252901033,597,347,37,0,981,981
Precinct,8252901034,418,278,27,0,723,723
Precinct,8252901043,435,271,20,0,726,726
Precinct,8252901044,404,229,20,0,653,653
Precinct,8252901045,294,215,12,0,521,521
Precinct,8252901046,308,241,14,0,563,563
Precinct,8252901047,483,314,20,0,817,817
Precinct,8252901048,366,299,12,0,677,677
Precinct,8252901049,453,299,15,0,767,767
Precinct,8252901050,418,243,24,0,685,685
Precinct,8252901054,401,253,14,0,668,668
Precinct,8252901055,324,240,5,0,569,569
Precinct,8252901056,576,346,32,0,954,954
Precinct,8252901057,429,242,17,1,689,689
Precinct,8252901058,584,211,19,0,814,814
Precinct,8252901059,508,298,18,0,824,824
Precinct,8252901060,314,349,11,0,674,674
Precinct,8252901061,498,293,32,0,823,823
Precinct,8252901062,422,348,14,0,784,784
Precinct,8252901063,478,323,20,1,822,822
Precinct,8252901064,480,242,35,1,758,758
Precinct,8252901065,491,264,20,0,775,775
Precinct,8252901066,196,119,6,0,321,321
Precinct,8252901067,215,141,8,4,368,368
Precinct,8252901068,574,276,30,1,881,881
Precinct,8252901069,426,417,22,0,865,865
Precinct,8252901070,318,367,11,0,696,696
Precinct,8253301277,16,12,1,0,29,29
Precinct,8253401039,359,218,30,0,607,607
Precinct,8253401040,311,256,34,1,602,602
Precinct,8253401051,488,379,33,4,904,904
Precinct,8253401052,233,176,18,0,427,427
Precinct,8253401053,438,326,27,0,791,791
Precinct,8253401090,315,170,12,0,497,497
Precinct,8253401091,328,208,31,0,567,567
Precinct,8253401092,410,386,31,0,827,827
Precinct,8253401095,372,292,50,1,715,715
Precinct,8253401096,340,250,28,5,623,623
Precinct,8253401098,328,282,36,0,646,646
Precinct,8253401099,264,151,20,0,435,435
Precinct,8253401100,446,285,35,2,768,768
Precinct,8253401101,426,243,17,0,686,686
Precinct,8253401102,375,280,36,0,691,691
Precinct,8253401104,389,242,20,1,652,652
Precinct,8253401273,297,119,22,2,440,440
Precinct,8253401278,174,74,4,0,252,252
Precinct,8253501015,414,214,30,0,658,658
Precinct,8253501016,552,284,31,1,868,868
Precinct,8253501031,423,239,29,0,691,691
Precinct,8253501272,339,192,28,0,559,559
County,Larimer,4154,5140,329,7,9630,9630
Precinct,8236435505,512,624,43,0,1179,1179
Precinct,8236435506,516,682,42,0,1240,1240
Precinct,8236435510,606,667,37,4,1314,1314
Precinct,8236435511,648,628,39,1,1316,1316
Precinct,8236435512,650,789,67,1,1507,1507
Precinct,8236435513,383,526,43,1,953,953
Precinct,8236535501,421,629,22,0,1072,1072
Precinct,8236535502,418,595,36,0,1049,1049
County,Weld,32110,49749,3267,31,85157,85157
Precinct,8014862135,11,27,1,0,39,39
Precinct,8014862304,224,312,22,0,558,558
Precinct,8014862305,227,318,30,0,575,575
Precinct,8014862306,209,274,29,0,512,512
Precinct,8014862307,241,439,27,0,707,707
Precinct,8014862308,131,474,21,0,626,626
Precinct,8014862309,132,628,25,0,785,785
Precinct,8014862310,133,674,14,0,821,821
Precinct,8014862311,166,625,25,0,816,816
Precinct,8015062400,0,0,0,0,0,0
Precinct,8015062401,0,0,0,0,0,0
Precinct,8015062403,0,0,0,0,0,0
Precinct,8015062500,0,0,0,0,0,0
Precinct,8015062600,0,0,0,0,0,0
Precinct,8015062602,0,0,0,0,0,0
Precinct,8016362134,135,733,26,0,894,894
Precinct,8016362329,48,318,12,1,379,379
Precinct,8016462148,295,418,24,0,737,737
Precinct,8016462149,280,492,30,1,803,803
Precinct,8016462150,303,515,23,0,841,841
Precinct,8016462151,297,449,29,0,775,775
Precinct,8016462152,195,281,13,0,489,489
Precinct,8016462153,315,549,27,0,891,891
Precinct,8016462154,315,596,27,0,938,938
Precinct,8016462245,369,577,42,0,988,988
Precinct,8016462246,382,539,30,0,951,951
Precinct,8016462247,371,683,21,0,1075,1075
Precinct,8016462248,362,538,24,0,924,924
Precinct,8016462249,359,563,36,0,958,958
Precinct,8016462250,323,535,39,0,897,897
Precinct,8016462251,327,568,32,0,927,927
Precinct,8016462252,188,245,16,0,449,449
Precinct,8016462253,241,457,20,0,718,718
Precinct,8016462254,177,262,14,0,453,453
Precinct,8016462255,242,375,20,2,639,639
Precinct,8016462256,235,491,18,0,744,744
Precinct,8016462257,320,572,27,0,919,919
Precinct,8016462258,430,669,34,0,1133,1133
Precinct,8016562155,70,424,9,0,503,503
Precinct,8134862222,48,110,1,1,160,160
Precinct,8134862312,181,361,13,0,555,555
Precinct,8134862313,319,600,38,0,957,957
Precinct,8134862314,244,288,26,1,559,559
Precinct,8134862315,289,348,26,0,663,663
Precinct,8134862316,241,279,35,0,555,555
Precinct,8134862317,158,326,37,0,521,521
Precinct,8134862318,257,551,44,0,852,852
Precinct,8134862319,239,544,44,2,829,829
Precinct,8134862320,254,520,34,0,808,808
Precinct,8135062136,208,117,15,0,340,340
Precinct,8135062137,216,139,20,2,377,377
Precinct,8135062138,470,208,31,1,710,710
Precinct,8135062139,208,218,15,0,441,441
Precinct,8135062140,210,174,18,0,402,402
Precinct,8135062141,483,324,22,0,829,829
Precinct,8135062142,507,289,40,0,836,836
Precinct,8135062143,385,349,36,1,771,771
Precinct,8135062144,243,175,19,0,437,437
Precinct,8135062145,323,304,35,2,664,664
Precinct,8135062146,423,422,68,0,913,913
Precinct,8135062147,284,257,35,0,576,576
Precinct,8135062235,492,539,46,0,1077,1077
Precinct,8135062236,281,342,16,1,640,640
Precinct,8135062237,317,474,28,0,819,819
Precinct,8135062238,187,286,27,0,500,500
Precinct,8135062239,127,375,12,0,514,514
Precinct,8135062330,14,44,2,0,60,60
Precinct,8135062331,169,253,28,0,450,450
Precinct,8135062332,317,497,54,0,868,868
Precinct,8135062333,231,285,25,0,541,541
Precinct,8135062345,280,370,32,0,682,682
Precinct,8135062346,302,428,47,0,777,777
Precinct,8135062347,279,336,30,0,645,645
Precinct,8135062348,212,200,22,0,434,434
Precinct,8135062349,277,282,17,0,576,576
Precinct,8135062350,185,132,24,0,341,341
Precinct,8135062351,328,330,34,1,693,693
Precinct,8135062352,394,327,15,0,736,736
Precinct,8135062360,39,36,1,0,76,76
Precinct,8136362404,0,0,0,0,0,0
Precinct,8136462240,66,87,12,0,165,165
Precinct,8136462241,298,275,15,2,590,590
Precinct,8136462242,369,523,37,0,929,929
Precinct,8136462243,380,402,46,0,828,828
Precinct,8136462244,362,460,23,1,846,846
Precinct,8136462264,0,0,0,0,0,0
Precinct,8136462501,0,0,0,0,0,0
Precinct,8231962220,407,530,28,0,965,965
Precinct,8231962221,274,369,29,0,672,672
Precinct,8231962223,455,624,41,0,1120,1120
Precinct,8231962224,296,342,17,2,657,657
Precinct,8231962225,458,564,45,0,1067,1067
Precinct,8231962226,385,619,35,0,1039,1039
Precinct,8231962227,473,727,52,2,1254,1254
Precinct,8231962228,410,577,28,1,1016,1016
Precinct,8231962229,332,528,29,0,889,889
Precinct,8231962230,548,753,32,0,1333,1333
Precinct,8231962231,412,603,43,0,1058,1058
Precinct,8231962232,422,482,56,0,960,960
Precinct,8231962233,295,455,35,0,785,785
Precinct,8231962234,315,449,39,0,803,803
Precinct,8231962262,176,168,17,0,361,361
Precinct,8231962263,330,548,30,0,908,908
Precinct,8231962323,60,195,6,0,261,261
Precinct,8231962324,267,393,38,1,699,699
Precinct,8231962325,406,618,43,0,1067,1067
Precinct,8231962326,290,362,26,0,678,678
Precinct,8231962327,220,320,17,0,557,557
Precinct,8231962328,325,402,22,1,750,750
Precinct,8233362601,0,0,0,0,0,0
Precinct,8234862216,7,86,1,0,94,94
Precinct,8234862217,18,102,3,0,123,123
Precinct,8234862321,27,130,11,0,168,168
Precinct,8234862322,8,38,0,0,46,46
Precinct,8234862361,2,28,0,0,30,30
Precinct,8236462200,429,751,34,2,1216,1216
Precinct,8236462201,276,604,34,0,914,914
Precinct,8236462202,318,689,36,1,1044,1044
Precinct,8236462203,236,662,26,0,924,924
Precinct,8236462204,264,518,47,0,829,829
Precinct,8236462205,189,327,20,0,536,536
Precinct,8236462206,233,617,29,1,880,880
Precinct,8236462207,324,456,21,0,801,801
Precinct,8236462208,408,686,48,0,1142,1142
Precinct,8236462209,208,394,27,0,629,629
Precinct,8236462210,339,780,19,0,1138,1138
Precinct,8236462211,259,507,27,0,793,793
Precinct,8236462212,233,456,36,0,725,725
Precinct,8236462213,184,464,17,0,665,665
Precinct,8236462214,197,310,40,1,548,548
Precinct,8236462215,172,396,25,0,593,593
Precinct,8236562156,13,107,4,0,124,124
Precinct,8236562259,61,207,22,0,290,290