,,Democratic,Republican,Libertarian,Total Votes Cast,Total Ballots Cast
U.S. Congressperson District,7,199758,144066,18186,362010,362010
County,Adams,77269,52474,7315,137058,137058
Precinct,7213001130,111,92,10,213,213
Precinct,7213001140,238,180,20,438,438
Precinct,7213001141,341,277,29,647,647
Precinct,7213001199,224,312,32,568,568
Precinct,7213001200,26,87,1,114,114
Precinct,7213001201,95,117,10,222,222
Precinct,7213001202,138,178,15,331,331
Precinct,7213001203,139,141,6,286,286
Precinct,7213001204,264,281,31,576,576
Precinct,7213001205,514,477,35,1026,1026
Precinct,7213001206,513,445,46,1004,1004
Precinct,7213001207,293,222,33,548,548
Precinct,7213001210,462,474,57,993,993
Precinct,7213001211,192,149,15,356,356
Precinct,7213001212,122,122,6,250,250
Precinct,7213001213,142,140,19,301,301
Precinct,7213001214,404,426,30,860,860
Precinct,7213001215,438,541,42,1021,1021
Precinct,7213001225,69,116,4,189,189
Precinct,7213101117,812,341,66,1219,1219
Precinct,7213101118,449,243,26,718,718
Precinct,7213201001,682,236,78,996,996
Precinct,7213201002,771,282,63,1116,1116
Precinct,7213201003,631,265,46,942,942
Precinct,7213201004,403,195,31,629,629
Precinct,7213201005,860,278,54,1192,1192
Precinct,7213201006,504,162,35,701,701
Precinct,7213201007,562,358,43,963,963
Precinct,7213201008,476,250,48,774,774
Precinct,7213201009,451,247,25,723,723
Precinct,7213201021,677,290,53,1020,1020
Precinct,7213201022,693,314,45,1052,1052
Precinct,7213201023,491,238,39,768,768
Precinct,7213201119,603,262,71,936,936
Precinct,7213201120,553,277,60,890,890
Precinct,7213201121,498,257,43,798,798
Precinct,7213201122,349,162,18,529,529
Precinct,7213201123,687,206,62,955,955
Precinct,7213201124,711,233,66,1010,1010
Precinct,7213201125,870,317,59,1246,1246
Precinct,7213201126,744,304,62,1110,1110
Precinct,7213201127,834,299,79,1212,1212
Precinct,7213201128,762,250,54,1066,1066
Precinct,7213201129,626,309,61,996,996
Precinct,7213201208,251,146,24,421,421
Precinct,7213201209,310,226,42,578,578
Precinct,7213201216,621,525,79,1225,1225
Precinct,7213201217,325,286,36,647,647
Precinct,7213201218,293,308,30,631,631
Precinct,7213201219,118,114,10,242,242
Precinct,7213201220,0,0,0,0,0
Precinct,7213201221,200,192,14,406,406
Precinct,7213201222,0,0,0,0,0
Precinct,7213201223,0,0,0,0,0
Precinct,7213201224,7,20,2,29,29
Precinct,7213401027,340,129,35,504,504
Precinct,7213401030,411,261,48,720,720
Precinct,7213401035,437,251,46,734,734
Precinct,7213401036,332,288,27,647,647
Precinct,7213401042,443,256,61,760,760
Precinct,7213501010,621,319,73,1013,1013
Precinct,7213501011,741,328,71,1140,1140
Precinct,7213501012,601,263,59,923,923
Precinct,7213501013,751,367,87,1205,1205
Precinct,7213501014,505,287,65,857,857
Precinct,7213501015,609,297,60,966,966
Precinct,7213501016,537,315,40,892,892
Precinct,7213501017,461,267,42,770,770
Precinct,7213501018,454,286,57,797,797
Precinct,7213501019,339,195,43,577,577
Precinct,7213501020,585,183,47,815,815
Precinct,7213501024,694,264,44,1002,1002
Precinct,7213501025,628,284,48,960,960
Precinct,7213501026,726,343,83,1152,1152
Precinct,7243101078,192,226,28,446,446
Precinct,7243101079,315,395,22,732,732
Precinct,7243101085,479,478,42,999,999
Precinct,7243101086,409,460,39,908,908
Precinct,7243101088,497,453,47,997,997
Precinct,7243101089,520,427,55,1002,1002
Precinct,7243101093,568,497,61,1126,1126
Precinct,7243101094,510,453,38,1001,1001
Precinct,7243101097,482,387,38,907,907
Precinct,7243101105,65,42,14,121,121
Precinct,7243101134,588,456,71,1115,1115
Precinct,7243101135,595,511,73,1179,1179
Precinct,7243101136,435,416,26,877,877
Precinct,7243101137,626,541,66,1233,1233
Precinct,7243101145,610,483,48,1141,1141
Precinct,7243101146,453,341,53,847,847
Precinct,7243101147,666,523,85,1274,1274
Precinct,7243101149,458,498,39,995,995
Precinct,7243401037,377,186,47,610,610
Precinct,7243401038,631,371,78,1080,1080
Precinct,7243401039,491,308,48,847,847
Precinct,7243401040,492,369,59,920,920
Precinct,7243401041,487,272,47,806,806
Precinct,7243401051,571,534,59,1164,1164
Precinct,7243401052,768,436,84,1288,1288
Precinct,7243401053,510,446,50,1006,1006
Precinct,7243401080,412,449,34,895,895
Precinct,7243401081,447,355,40,842,842
Precinct,7243401082,396,407,27,830,830
Precinct,7243401083,487,438,44,969,969
Precinct,7243401084,279,294,25,598,598
Precinct,7243401087,464,391,72,927,927
Precinct,7243401090,575,302,67,944,944
Precinct,7243401091,502,295,67,864,864
Precinct,7243401092,576,465,44,1085,1085
Precinct,7243401095,537,411,65,1013,1013
Precinct,7243401096,445,356,65,866,866
Precinct,7243401098,459,363,47,869,869
Precinct,7243401099,338,243,27,608,608
Precinct,7243401100,589,385,63,1037,1037
Precinct,7243401101,530,334,51,915,915
Precinct,7243401102,523,348,53,924,924
Precinct,7243401103,201,166,28,395,395
Precinct,7243401104,434,344,51,829,829
Precinct,7243501031,593,377,64,1034,1034
Precinct,7243501032,529,290,37,856,856
Precinct,7243501033,710,448,56,1214,1214
Precinct,7243501034,531,368,38,937,937
Precinct,7243501043,491,373,24,888,888
Precinct,7243501044,484,293,39,816,816
Precinct,7243501045,342,270,29,641,641
Precinct,7243501046,313,363,12,688,688
Precinct,7243501047,512,444,23,979,979
Precinct,7243501048,383,355,13,751,751
Precinct,7243501049,473,405,50,928,928
Precinct,7243501050,426,351,33,810,810
Precinct,7243501054,364,321,38,723,723
Precinct,7243501055,332,350,16,698,698
Precinct,7243501056,518,413,55,986,986
Precinct,7243501057,435,329,24,788,788
Precinct,7243501058,558,323,36,917,917
Precinct,7243501059,541,354,26,921,921
Precinct,7243501060,381,421,38,840,840
Precinct,7243501061,645,436,45,1126,1126
Precinct,7243501062,378,416,25,819,819
Precinct,7243501063,371,397,27,795,795
Precinct,7243501064,608,397,82,1087,1087
Precinct,7243501065,448,367,47,862,862
Precinct,7243501066,116,90,25,231,231
Precinct,7243501067,236,240,22,498,498
Precinct,7243501068,569,416,52,1037,1037
Precinct,7243501069,394,563,51,1008,1008
Precinct,7243501070,322,464,33,819,819
Precinct,7253001131,315,183,36,534,534
Precinct,7253001132,466,271,49,786,786
Precinct,7253001138,297,311,48,656,656
Precinct,7253001139,77,97,10,184,184
Precinct,7253001142,290,428,29,747,747
Precinct,7253001143,314,254,32,600,600
Precinct,7253001144,573,511,51,1135,1135
Precinct,7253001148,361,336,37,734,734
Precinct,7253101106,730,445,70,1245,1245
Precinct,7253101107,537,376,53,966,966
Precinct,7253101108,603,366,61,1030,1030
Precinct,7253101109,544,352,49,945,945
Precinct,7253101110,391,250,41,682,682
Precinct,7253101111,541,309,52,902,902
Precinct,7253101112,938,329,110,1377,1377
Precinct,7253101113,589,328,48,965,965
Precinct,7253101114,470,254,46,770,770
Precinct,7253101115,551,224,46,821,821
Precinct,7253101116,286,157,28,471,471
Precinct,7253101133,536,413,72,1021,1021
Precinct,7253401028,460,194,44,698,698
Precinct,7253401029,644,245,55,944,944
County,Jefferson,122489,91592,10871,224952,224952
Precinct,7162430084,647,498,89,1234,1234
Precinct,7162430085,684,465,110,1259,1259
Precinct,7162430086,838,479,48,1365,1365
Precinct,7162430087,506,276,22,804,804
Precinct,7162430088,692,552,109,1353,1353
Precinct,7162430089,634,326,85,1045,1045
Precinct,7162430090,765,425,72,1262,1262
Precinct,7162430091,763,573,33,1369,1369
Precinct,7162430092,675,341,40,1056,1056
Precinct,7162430093,919,423,73,1415,1415
Precinct,7162430094,710,256,60,1026,1026
Precinct,7162430095,709,344,49,1102,1102
Precinct,7162530096,58,54,4,116,116
Precinct,7162530097,133,181,8,322,322
Precinct,7192430098,368,499,26,893,893
Precinct,7192730099,745,809,40,1594,1594
Precinct,7192730100,847,833,46,1726,1726
Precinct,7192730101,874,720,72,1666,1666
Precinct,7192730102,531,518,39,1088,1088
Precinct,7192730103,745,742,48,1535,1535
Precinct,7192730104,469,489,47,1005,1005
Precinct,7192730105,573,527,65,1165,1165
Precinct,7192730106,795,820,60,1675,1675
Precinct,7192730107,678,714,57,1449,1449
Precinct,7192730108,547,520,41,1108,1108
Precinct,7192730109,577,557,43,1177,1177
Precinct,7192730110,607,663,45,1315,1315
Precinct,7192730111,848,695,63,1606,1606
Precinct,7192730112,625,559,58,1242,1242
Precinct,7192730113,501,727,42,1270,1270
Precinct,7192730114,716,683,78,1477,1477
Precinct,7192730115,725,750,63,1538,1538
Precinct,7192730116,563,754,35,1352,1352
Precinct,7192730117,753,647,42,1442,1442
Precinct,7192730118,826,653,50,1529,1529
Precinct,7192730119,870,583,91,1544,1544
Precinct,7192730120,940,590,109,1639,1639
Precinct,7192730121,680,525,64,1269,1269
Precinct,7192730122,820,655,88,1563,1563
Precinct,7192730123,744,683,66,1493,1493
Precinct,7192730124,845,549,86,1480,1480
Precinct,7192730125,604,402,68,1074,1074
Precinct,7192730126,770,737,67,1574,1574
Precinct,7192930127,705,549,66,1320,1320
Precinct,7192930128,802,627,84,1513,1513
Precinct,7192930129,553,427,67,1047,1047
Precinct,7192930130,552,477,56,1085,1085
Precinct,7192930131,563,399,78,1040,1040
Precinct,7192930132,606,467,63,1136,1136
Precinct,7192930133,807,588,104,1499,1499
Precinct,7192930134,596,432,66,1094,1094
Precinct,7192930135,455,333,35,823,823
Precinct,7192930136,717,687,63,1467,1467
Precinct,7192930137,703,655,87,1445,1445
Precinct,7192930138,591,463,58,1112,1112
Precinct,7192930139,681,510,79,1270,1270
Precinct,7192930140,653,518,39,1210,1210
Precinct,7192930141,780,588,83,1451,1451
Precinct,7192930142,854,599,81,1534,1534
Precinct,7192930143,713,543,47,1303,1303
Precinct,7192930144,554,405,53,1012,1012
Precinct,7192930145,619,359,59,1037,1037
Precinct,7192930146,907,559,117,1583,1583
Precinct,7192930147,877,563,110,1550,1550
Precinct,7192930148,832,604,79,1515,1515
Precinct,7192930149,813,529,69,1411,1411
Precinct,7192930150,570,522,52,1144,1144
Precinct,7192930151,823,652,70,1545,1545
Precinct,7192930152,725,595,59,1379,1379
Precinct,7192930153,851,589,86,1526,1526
Precinct,7192930154,744,587,83,1414,1414
Precinct,7192930155,748,573,83,1404,1404
Precinct,7192930156,683,561,71,1315,1315
Precinct,7192930157,607,496,63,1166,1166
Precinct,7202330158,762,527,68,1357,1357
Precinct,7202330159,935,464,104,1503,1503
Precinct,7202330160,653,361,82,1096,1096
Precinct,7202330161,436,293,55,784,784
Precinct,7202330162,633,349,39,1021,1021
Precinct,7202330163,714,405,65,1184,1184
Precinct,7202330164,882,630,34,1546,1546
Precinct,7202330165,823,620,51,1494,1494
Precinct,7202330166,876,557,59,1492,1492
Precinct,7202330167,446,320,64,830,830
Precinct,7202330168,423,376,19,818,818
Precinct,7202330169,555,620,23,1198,1198
Precinct,7202330170,651,689,46,1386,1386
Precinct,7202330171,821,684,60,1565,1565
Precinct,7202330172,770,560,71,1401,1401
Precinct,7202330173,830,453,103,1386,1386
Precinct,7202330174,776,612,52,1440,1440
Precinct,7202330175,832,567,74,1473,1473
Precinct,7202330176,647,560,53,1260,1260
Precinct,7202330177,848,649,79,1576,1576
Precinct,7202330178,852,519,86,1457,1457
Precinct,7202330179,850,600,69,1519,1519
Precinct,7202330180,472,265,56,793,793
Precinct,7202330181,727,552,88,1367,1367
Precinct,7202430182,629,817,52,1498,1498
Precinct,7202430183,518,661,28,1207,1207
Precinct,7202430184,755,653,63,1471,1471
Precinct,7202430185,706,529,46,1281,1281
Precinct,7202430186,883,550,76,1509,1509
Precinct,7202430187,570,519,24,1113,1113
Precinct,7202430188,630,311,50,991,991
Precinct,7202430189,947,582,45,1574,1574
Precinct,7202430190,497,417,35,949,949
Precinct,7202430191,1006,476,67,1549,1549
Precinct,7202430192,802,514,49,1365,1365
Precinct,7202430193,691,536,41,1268,1268
Precinct,7202430194,1137,375,92,1604,1604
Precinct,7202430195,864,506,89,1459,1459
Precinct,7202430196,860,333,60,1253,1253
Precinct,7202430197,618,258,41,917,917
Precinct,7202430198,844,612,104,1560,1560
Precinct,7202430199,505,516,37,1058,1058
Precinct,7202430200,938,459,85,1482,1482
Precinct,7202430201,798,583,54,1435,1435
Precinct,7202530202,578,533,23,1134,1134
Precinct,7202530203,217,179,33,429,429
Precinct,7202530204,648,426,59,1133,1133
Precinct,7202730205,698,767,52,1517,1517
Precinct,7202730206,443,712,34,1189,1189
Precinct,7202730207,685,693,47,1425,1425
Precinct,7202730208,696,827,38,1561,1561
Precinct,7202730209,578,769,56,1403,1403
Precinct,7202730210,806,928,58,1792,1792
Precinct,7202730211,1144,1208,96,2448,2448
Precinct,7202830212,751,600,40,1391,1391
Precinct,7202830213,657,471,43,1171,1171
Precinct,7202830214,802,754,49,1605,1605
Precinct,7202830215,880,878,55,1813,1813
Precinct,7202830216,689,517,85,1291,1291
Precinct,7202830217,483,429,43,955,955
Precinct,7222230218,801,935,45,1781,1781
Precinct,7222230219,350,360,37,747,747
Precinct,7222330220,581,238,66,885,885
Precinct,7222330221,825,632,67,1524,1524
Precinct,7222330222,548,329,45,922,922
Precinct,7222330223,678,521,54,1253,1253
Precinct,7222330224,726,294,104,1124,1124
Precinct,7222330225,588,309,65,962,962
Precinct,7222330226,1000,389,103,1492,1492
Precinct,7222330227,943,293,95,1331,1331
Precinct,7222330228,967,699,54,1720,1720
Precinct,7222330229,771,552,77,1400,1400
Precinct,7222430230,716,212,57,985,985
Precinct,7222430231,911,275,79,1265,1265
Precinct,7222830232,663,589,70,1322,1322
Precinct,7222830233,501,259,17,777,777
Precinct,7222830234,567,437,35,1039,1039
Precinct,7222830235,700,531,57,1288,1288
Precinct,7222830236,704,595,51,1350,1350
Precinct,7222830237,652,393,51,1096,1096
Precinct,7222830238,729,411,74,1214,1214
Precinct,7222830239,547,410,63,1020,1020
Precinct,7222830240,703,482,86,1271,1271
Precinct,7222830241,649,299,100,1048,1048
Precinct,7222830242,627,374,66,1067,1067
Precinct,7222830243,613,465,38,1116,1116
Precinct,7222830244,595,430,61,1086,1086
Precinct,7222830245,841,420,89,1350,1350
Precinct,7222830246,469,346,36,851,851
Precinct,7222830247,699,427,83,1209,1209
Precinct,7222830248,624,309,76,1009,1009
Precinct,7222830249,874,447,108,1429,1429
Precinct,7222830250,673,407,66,1146,1146
Precinct,7222830251,970,468,98,1536,1536
Precinct,7222830252,897,580,72,1549,1549
Precinct,7222830253,477,470,44,991,991
Precinct,7222830254,765,443,74,1282,1282
Precinct,7222830255,668,345,72,1085,1085
Precinct,7222830256,927,613,64,1604,1604
Precinct,7222830257,664,736,47,1447,1447
Precinct,7222830258,516,486,65,1067,1067