,,Republican,Democratic,Libertarian,Unaffiliated,Total Votes Cast,Total Ballots Cast
U.S. Congressperson District,4,185292,83727,9472,8016,286507,286507
County,Adams,2221,512,120,117,2970,2970
Precinct,4253001245,188,32,9,8,237,237
Precinct,4255601241,27,2,1,0,30,30
Precinct,4255601246,473,118,30,46,667,667
Precinct,4255601247,244,48,13,9,314,314
Precinct,4255601248,1095,273,54,46,1468,1468
Precinct,4255601249,15,0,0,0,15,15
Precinct,4255601250,166,39,13,8,226,226
Precinct,4255601251,13,0,0,0,13,13
County,Arapahoe,2375,571,118,114,3178,3178
Precinct,4283603348,0,0,0,0,0,0
Precinct,4283603350,0,0,0,0,0,0
Precinct,4293603358,0,0,0,0,0,0
Precinct,4293603361,0,0,0,0,0,0
Precinct,4295603357,0,0,0,0,0,0
Precinct,4295603359,0,0,0,0,0,0
Precinct,4295603362,989,253,50,37,1329,1329
Precinct,4295603363,522,123,24,19,688,688
Precinct,4295603364,568,142,28,43,781,781
Precinct,4295603365,296,53,16,15,380,380
County,Baca,1356,321,61,59,1797,1797
Precinct,4356405001,185,33,2,5,225,225
Precinct,4356405002,198,38,8,5,249,249
Precinct,4356405003,106,22,9,9,146,146
Precinct,4356405004,198,38,11,14,261,261
Precinct,4356405005,88,16,5,1,110,110
Precinct,4356405006,97,23,8,9,137,137
Precinct,4356405007,211,68,8,8,295,295
Precinct,4356405008,209,77,10,7,303,303
Precinct,4356405009,64,6,0,1,71,71
County,Bent,974,487,45,59,1565,1565
Precinct,4356406001,180,39,6,9,234,234
Precinct,4356406002,310,63,6,8,387,387
Precinct,4356406003,133,178,21,10,342,342
Precinct,4356406004,121,133,8,9,271,271
Precinct,4356406005,230,74,4,23,331,331
County,Boulder,15848,17823,1495,1051,36217,36217
Precinct,4171107616,321,393,29,21,764,764
Precinct,4171107617,425,625,53,21,1124,1124
Precinct,4171107618,376,439,30,15,860,860
Precinct,4171107619,220,461,35,16,732,732
Precinct,4171107620,363,525,40,26,954,954
Precinct,4171107621,204,460,22,24,710,710
Precinct,4171107622,131,283,22,17,453,453
Precinct,4171107623,166,479,36,18,699,699
Precinct,4171107624,170,351,21,8,550,550
Precinct,4171107625,129,442,24,13,608,608
Precinct,4171107626,280,402,31,30,743,743
Precinct,4171107627,186,225,19,17,447,447
Precinct,4171107628,239,292,25,16,572,572
Precinct,4171107629,111,208,22,14,355,355
Precinct,4171107630,180,315,21,15,531,531
Precinct,4171107631,136,183,19,13,351,351
Precinct,4171107632,397,327,35,26,785,785
Precinct,4171107633,155,211,35,17,418,418
Precinct,4171107634,194,249,23,17,483,483
Precinct,4171107635,324,232,20,20,596,596
Precinct,4171107636,402,345,33,34,814,814
Precinct,4171107637,323,382,46,18,769,769
Precinct,4171107638,417,317,24,18,776,776
Precinct,4171107639,338,290,22,20,670,670
Precinct,4171107640,298,259,24,20,601,601
Precinct,4171107641,269,229,19,12,529,529
Precinct,4171107642,300,389,42,17,748,748
Precinct,4171107643,183,217,28,13,441,441
Precinct,4171107644,136,243,23,22,424,424
Precinct,4171107645,276,262,18,16,572,572
Precinct,4171107646,372,243,14,14,643,643
Precinct,4171107647,385,308,34,16,743,743
Precinct,4171107648,317,208,22,26,573,573
Precinct,4171107649,191,185,21,9,406,406
Precinct,4171107650,224,200,19,24,467,467
Precinct,4171107651,283,297,30,19,629,629
Precinct,4171107652,256,252,29,28,565,565
Precinct,4171107653,288,242,10,11,551,551
Precinct,4171107654,385,420,37,17,859,859
Precinct,4171207600,602,385,38,20,1045,1045
Precinct,4171207601,429,434,27,31,921,921
Precinct,4171207602,296,201,19,16,532,532
Precinct,4171207603,430,393,35,26,884,884
Precinct,4171207604,388,259,31,17,695,695
Precinct,4171207605,291,286,24,21,622,622
Precinct,4171207606,199,241,23,27,490,490
Precinct,4171207607,289,326,16,16,647,647
Precinct,4171207608,170,274,16,19,479,479
Precinct,4171207609,74,162,12,9,257,257
Precinct,4171207610,240,437,39,22,738,738
Precinct,4171207611,254,317,25,20,616,616
Precinct,4171207612,261,301,28,16,606,606
Precinct,4171207613,237,277,18,16,548,548
Precinct,4171207614,416,466,31,16,929,929
Precinct,4171207615,227,311,16,5,559,559
Precinct,4181107706,57,76,3,8,144,144
Precinct,4181107707,298,141,22,14,475,475
Precinct,4181107708,340,146,15,14,515,515
County,Cheyenne,850,101,23,39,1013,1013
Precinct,4016509001,104,11,2,6,123,123
Precinct,4016509002,230,24,7,13,274,274
Precinct,4016509003,282,29,11,12,334,334
Precinct,4016509004,184,28,3,6,221,221
Precinct,4016509005,50,9,0,2,61,61
County,Crowley,902,327,31,62,1322,1322
Precinct,4356413001,187,62,8,15,272,272
Precinct,4356413002,152,55,6,14,227,227
Precinct,4356413003,133,51,1,4,189,189
Precinct,4356413004,156,37,7,13,213,213
Precinct,4356413005,145,62,6,7,220,220
Precinct,4356413006,129,60,3,9,201,201
County,Douglas,59935,24289,3370,1714,89308,89308
Precinct,4043918106,142,40,8,1,191,191
Precinct,4043918107,379,153,17,9,558,558
Precinct,4043918306,549,169,24,6,748,748
Precinct,4043918317,396,136,22,6,560,560
Precinct,4043918332,940,334,56,27,1357,1357
Precinct,4043918345,625,169,19,18,831,831
Precinct,4043918346,524,196,20,13,753,753
Precinct,4043918401,702,226,27,10,965,965
Precinct,4043918402,297,103,5,6,411,411
Precinct,4043918403,111,43,7,6,167,167
Precinct,4043918404,782,317,48,8,1155,1155
Precinct,4043918405,723,246,28,25,1022,1022
Precinct,4043918406,419,105,10,12,546,546
Precinct,4043918508,932,256,41,18,1247,1247
Precinct,4043918511,576,169,18,7,770,770
Precinct,4043918512,704,164,29,15,912,912
Precinct,4044418302,529,286,49,23,887,887
Precinct,4044418303,739,416,89,56,1300,1300
Precinct,4044418304,438,186,37,17,678,678
Precinct,4044418309,527,254,26,23,830,830
Precinct,4044418315,698,338,42,31,1109,1109
Precinct,4044418316,717,371,48,46,1182,1182
Precinct,4044418318,576,200,22,15,813,813
Precinct,4044418319,403,193,26,19,641,641
Precinct,4044418320,419,198,37,16,670,670
Precinct,4044418321,855,412,44,29,1340,1340
Precinct,4044418322,552,266,42,21,881,881
Precinct,4044418323,434,177,19,21,651,651
Precinct,4044418324,625,264,47,28,964,964
Precinct,4044418325,450,175,18,14,657,657
Precinct,4044418326,853,389,55,11,1308,1308
Precinct,4044418327,764,305,43,27,1139,1139
Precinct,4044418328,833,370,50,24,1277,1277
Precinct,4044418329,890,308,41,23,1262,1262
Precinct,4044418330,703,249,26,17,995,995
Precinct,4044418331,682,261,22,12,977,977
Precinct,4044418334,650,343,59,35,1087,1087
Precinct,4044518108,459,182,25,12,678,678
Precinct,4044518109,652,309,41,20,1022,1022
Precinct,4044518110,359,167,29,13,568,568
Precinct,4044518111,975,389,60,18,1442,1442
Precinct,4044518112,786,367,78,20,1251,1251
Precinct,4044518113,960,415,95,28,1498,1498
Precinct,4044518114,1243,425,91,43,1802,1802
Precinct,4044518261,780,339,17,6,1142,1142
Precinct,4044518262,659,296,23,14,992,992
Precinct,4044518263,1112,291,25,9,1437,1437
Precinct,4044518264,857,310,30,19,1216,1216
Precinct,4044518333,502,124,21,12,659,659
Precinct,4044518335,338,159,17,9,523,523
Precinct,4044518336,625,294,22,16,957,957
Precinct,4044518337,477,203,27,17,724,724
Precinct,4044518338,939,283,41,25,1288,1288
Precinct,4044518339,885,300,43,21,1249,1249
Precinct,4044518340,759,257,41,9,1066,1066
Precinct,4044518341,660,265,24,17,966,966
Precinct,4044518342,737,305,30,13,1085,1085
Precinct,4044518343,564,210,34,18,826,826
Precinct,4044518344,897,296,50,17,1260,1260
Precinct,4044518347,302,149,35,13,499,499
Precinct,4044518348,788,309,53,21,1171,1171
Precinct,4044518349,329,117,16,9,471,471
Precinct,4044518501,807,348,58,27,1240,1240
Precinct,4044518502,530,256,39,19,844,844
Precinct,4044518503,600,268,58,37,963,963
Precinct,4044518504,703,251,56,16,1026,1026
Precinct,4044518505,464,193,57,21,735,735
Precinct,4044518506,805,333,70,34,1242,1242
Precinct,4044518507,727,224,52,19,1022,1022
Precinct,4044518509,652,209,30,14,905,905
Precinct,4044518510,702,193,42,9,946,946
Precinct,4303918101,543,184,25,12,764,764
Precinct,4303918102,841,450,60,41,1392,1392
Precinct,4303918103,708,413,73,32,1226,1226
Precinct,4303918104,305,92,16,9,422,422
Precinct,4303918105,846,485,38,25,1394,1394
Precinct,4304418206,433,228,27,23,711,711
Precinct,4304418207,403,281,39,16,739,739
Precinct,4304418208,209,196,32,15,452,452
Precinct,4304418232,482,256,31,15,784,784
Precinct,4304418233,792,252,11,9,1064,1064
Precinct,4304418245,935,382,36,24,1377,1377
Precinct,4304418257,1305,565,59,31,1960,1960
Precinct,4304418301,525,307,35,26,893,893
Precinct,4304418307,528,231,34,18,811,811
Precinct,4304418308,591,318,34,11,954,954
Precinct,4304418311,402,200,25,11,638,638
Precinct,4304418312,767,333,35,18,1153,1153
Precinct,4304418313,470,219,15,10,714,714
Precinct,4304418314,468,176,22,11,677,677
Precinct,4304518258,787,258,21,13,1079,1079
Precinct,4304518259,712,252,18,9,991,991
Precinct,4304518260,1111,388,33,25,1557,1557
County,Elbert,9214,2152,437,462,12265,12265
Precinct,4016420001,319,82,17,28,446,446
Precinct,4016420002,969,255,46,62,1332,1332
Precinct,4016420003,635,151,32,28,846,846
Precinct,4016420004,750,195,32,24,1001,1001
Precinct,4016420005,373,69,15,11,468,468
Precinct,4016420006,779,189,40,45,1053,1053
Precinct,4016420007,696,188,36,26,946,946
Precinct,4016420008,423,102,19,17,561,561
Precinct,4016420009,539,113,28,25,705,705
Precinct,4016420010,689,223,38,39,989,989
Precinct,4016420011,574,121,19,30,744,744
Precinct,4016420012,623,136,42,31,832,832
Precinct,4016420013,581,80,20,25,706,706
Precinct,4016420014,715,168,35,53,971,971
Precinct,4016420015,549,80,18,18,665,665
County,Kiowa,602,84,16,45,747,747
Precinct,4356431001,117,14,3,4,138,138
Precinct,4356431002,194,25,5,17,241,241
Precinct,4356431003,245,42,6,13,306,306
Precinct,4356431004,46,3,2,11,62,62
County,Kit Carson,2439,393,55,93,2980,2980
Precinct,4016532001,216,35,8,6,265,265
Precinct,4016532002,136,39,7,11,193,193
Precinct,4016532003,212,45,7,10,274,274
Precinct,4016532004,220,32,2,8,262,262
Precinct,4016532005,300,36,5,10,351,351
Precinct,4016532006,199,44,4,9,256,256
Precinct,4016532007,180,22,2,6,210,210
Precinct,4016532008,182,33,3,5,223,223
Precinct,4016532009,204,29,4,9,246,246
Precinct,4016532010,92,13,3,1,109,109
Precinct,4016532011,146,16,3,8,173,173
Precinct,4016532012,158,22,4,5,189,189
Precinct,4016532013,194,27,3,5,229,229
County,Las Animas,2824,2128,163,338,5453,5453
Precinct,4356436001,150,20,3,4,177,177
Precinct,4356436002,54,16,0,2,72,72
Precinct,4356436003,309,130,14,40,493,493
Precinct,4356436004,180,177,12,19,388,388
Precinct,4356436005,164,81,12,3,260,260
Precinct,4356436006,169,98,4,12,283,283
Precinct,4356436007,204,121,10,18,353,353
Precinct,4356436008,81,72,7,15,175,175
Precinct,4356436009,218,95,14,16,343,343
Precinct,4356436010,221,202,8,24,455,455
Precinct,4356436011,137,250,15,24,426,426
Precinct,4356436012,216,155,20,37,428,428
Precinct,4356436013,119,136,15,23,293,293
Precinct,4356436014,126,164,8,22,320,320
Precinct,4356436015,247,206,11,49,513,513
Precinct,4356436016,229,205,10,30,474,474
County,Lincoln,1541,307,49,71,1968,1968
Precinct,4016437001,139,24,5,6,174,174
Precinct,4016437002,192,47,8,13,260,260
Precinct,4016437003,178,19,4,4,205,205
Precinct,4016437004,128,24,0,6,158,158
Precinct,4016437005,120,41,6,4,171,171
Precinct,4016437006,156,23,4,9,192,192
Precinct,4016437007,181,53,9,9,252,252
Precinct,4016437008,30,12,2,2,46,46
Precinct,4016437009,73,10,4,4,91,91
Precinct,4016437010,116,14,1,4,135,135
Precinct,4016437011,39,4,0,1,44,44
Precinct,4016437012,27,3,0,0,30,30
Precinct,4016437013,162,33,6,9,210,210
County,Logan,5688,1535,163,218,7604,7604
Precinct,4016538001,420,140,8,17,585,585
Precinct,4016538002,333,136,13,32,514,514
Precinct,4016538003,189,84,14,12,299,299
Precinct,4016538004,325,119,17,24,485,485
Precinct,4016538005,274,105,14,13,406,406
Precinct,4016538006,347,146,14,9,516,516
Precinct,4016538007,515,197,11,20,743,743
Precinct,4016538008,649,139,15,16,819,819
Precinct,4016538009,652,134,15,16,817,817
Precinct,4016538010,504,71,12,10,597,597
Precinct,4016538011,301,62,7,7,377,377
Precinct,4016538012,225,38,3,6,272,272
Precinct,4016538013,338,49,7,12,406,406
Precinct,4016538014,213,29,7,11,260,260
Precinct,4016538015,254,65,2,12,333,333
Precinct,4016538016,149,21,4,1,175,175
County,Morgan,6083,2081,197,259,8620,8620
Precinct,4016544001,772,146,22,23,963,963
Precinct,4016544002,313,67,10,8,398,398
Precinct,4016544003,371,129,7,13,520,520
Precinct,4016544004,465,102,9,16,592,592
Precinct,4016544005,416,121,11,17,565,565
Precinct,4016544006,328,184,16,20,548,548
Precinct,4016544007,226,120,10,10,366,366
Precinct,4016544008,205,110,12,7,334,334
Precinct,4016544009,263,185,11,16,475,475
Precinct,4016544010,373,149,15,18,555,555
Precinct,4016544011,558,119,10,13,700,700
Precinct,4016544012,143,25,5,5,178,178
Precinct,4016544013,281,49,6,20,356,356
Precinct,4016544014,268,118,15,19,420,420
Precinct,4016544015,286,149,11,12,458,458
Precinct,4016544016,352,132,15,22,521,521
Precinct,4016544017,463,176,12,20,671,671
County,Otero,4045,2161,161,216,6583,6583
Precinct,4354745001,395,205,18,8,626,626
Precinct,4354745002,216,100,6,15,337,337
Precinct,4354745003,419,142,11,11,583,583
Precinct,4354745004,294,93,7,19,413,413
Precinct,4354745005,100,134,6,10,250,250
Precinct,4354745006,255,67,6,12,340,340
Precinct,4354745007,151,102,9,12,274,274
Precinct,4354745008,173,162,10,13,358,358
Precinct,4354745009,222,159,12,6,399,399
Precinct,4354745010,136,135,8,5,284,284
Precinct,4354745011,331,102,20,12,465,465
Precinct,4354745012,246,178,8,26,458,458
Precinct,4354745013,93,174,10,16,293,293
Precinct,4354745014,321,152,9,14,496,496
Precinct,4354745015,182,115,2,9,308,308
Precinct,4354745016,347,99,13,20,479,479
Precinct,4354745017,164,42,6,8,220,220
County,Phillips,1504,331,39,53,1927,1927
Precinct,4016548001,238,57,5,8,308,308
Precinct,4016548002,62,12,3,2,79,79
Precinct,4016548003,177,41,4,4,226,226
Precinct,4016548004,294,70,8,10,382,382
Precinct,4016548005,138,19,3,5,165,165
Precinct,4016548006,214,47,6,6,273,273
Precinct,4016548007,270,55,6,14,345,345
Precinct,4016548008,111,30,4,4,149,149
County,Prowers,2887,861,81,116,3945,3945
Precinct,4356450001,138,63,6,9,216,216
Precinct,4356450002,180,31,3,7,221,221
Precinct,4356450003,157,75,3,3,238,238
Precinct,4356450004,156,66,6,10,238,238
Precinct,4356450005,123,101,8,12,244,244
Precinct,4356450006,278,47,4,12,341,341
Precinct,4356450007,281,56,4,12,353,353
Precinct,4356450008,257,99,6,10,372,372
Precinct,4356450009,147,63,0,6,216,216
Precinct,4356450010,454,94,8,6,562,562
Precinct,4356450011,229,75,8,13,325,325
Precinct,4356450012,260,57,13,5,335,335
Precinct,4356450013,227,34,12,11,284,284
County,Sedgwick,857,227,30,54,1168,1168
Precinct,4016558001,207,57,10,13,287,287
Precinct,4016558002,189,36,5,9,239,239
Precinct,4016558003,173,62,5,16,256,256
Precinct,4016558004,118,42,2,8,170,170
Precinct,4016558005,170,30,8,8,216,216
County,Washington,1980,228,48,36,2292,2292
Precinct,4016461001,85,11,4,0,100,100
Precinct,4016461002,954,127,24,23,1128,1128
Precinct,4016461003,113,9,1,1,124,124
Precinct,4016461004,373,42,8,5,428,428
Precinct,4016461005,152,15,6,2,175,175
Precinct,4016461006,303,24,5,5,337,337
County,Weld,57667,26283,2707,2775,89432,89432
Precinct,4014862118,1238,279,42,50,1609,1609
Precinct,4014862119,333,97,18,15,463,463
Precinct,4014862126,576,207,33,26,842,842
Precinct,4014862127,423,130,18,15,586,586
Precinct,4014862128,954,194,20,24,1192,1192
Precinct,4014862316,431,96,17,16,560,560
Precinct,4016362100,556,149,20,33,758,758
Precinct,4016362101,249,29,6,6,290,290
Precinct,4016362102,176,23,4,4,207,207
Precinct,4016362103,237,38,4,13,292,292
Precinct,4016362104,929,158,34,39,1160,1160
Precinct,4016362308,997,192,24,31,1244,1244
Precinct,4016362310,787,213,25,42,1067,1067
Precinct,4016362311,931,189,42,43,1205,1205
Precinct,4016362312,244,40,12,9,305,305
Precinct,4016362314,693,367,49,90,1199,1199
Precinct,4134862120,325,53,8,6,392,392
Precinct,4134862124,710,267,33,29,1039,1039
Precinct,4134862125,721,267,18,19,1025,1025
Precinct,4134862135,510,175,8,23,716,716
Precinct,4134862136,518,211,15,28,772,772
Precinct,4134862146,103,92,6,5,206,206
Precinct,4134862201,746,269,26,35,1076,1076
Precinct,4134862212,600,277,13,27,917,917
Precinct,4134862213,683,255,21,39,998,998
Precinct,4134862214,769,310,13,25,1117,1117
Precinct,4134862215,618,235,7,17,877,877
Precinct,4134862217,564,333,34,18,949,949
Precinct,4134862221,505,243,15,29,792,792
Precinct,4134862222,625,290,17,20,952,952
Precinct,4134862223,645,263,24,27,959,959
Precinct,4134862224,291,137,19,12,459,459
Precinct,4134862226,651,358,31,23,1063,1063
Precinct,4134862228,477,208,26,27,738,738
Precinct,4134862235,708,240,14,30,992,992
Precinct,4134862238,492,197,6,23,718,718
Precinct,4134862241,351,155,9,17,532,532
Precinct,4134862243,921,391,19,48,1379,1379
Precinct,4134862246,396,163,33,24,616,616
Precinct,4134862326,418,195,18,25,656,656
Precinct,4134862331,535,227,20,19,801,801
Precinct,4134862333,265,95,7,20,387,387
Precinct,4134862338,47,18,0,4,69,69
Precinct,4134962145,11,0,0,0,11,11
Precinct,4135062106,257,216,21,26,520,520
Precinct,4135062107,399,571,24,46,1040,1040
Precinct,4135062108,388,291,18,36,733,733
Precinct,4135062109,425,295,24,47,791,791
Precinct,4135062110,223,304,19,24,570,570
Precinct,4135062111,365,329,23,22,739,739
Precinct,4135062112,335,510,50,35,930,930
Precinct,4135062114,338,341,16,14,709,709
Precinct,4135062132,470,203,19,24,716,716
Precinct,4135062137,265,348,37,26,676,676
Precinct,4135062211,443,187,24,18,672,672
Precinct,4135062220,558,369,21,28,976,976
Precinct,4135062236,615,246,25,37,923,923
Precinct,4135062249,327,111,18,13,469,469
Precinct,4135062317,386,314,33,19,752,752
Precinct,4135062318,300,172,11,17,500,500
Precinct,4135062319,309,248,21,25,603,603
Precinct,4135062321,230,191,27,23,471,471
Precinct,4135062322,413,248,23,38,722,722
Precinct,4135062323,409,242,25,29,705,705
Precinct,4135062324,703,366,44,38,1151,1151
Precinct,4135062325,300,167,26,22,515,515
Precinct,4135062330,559,294,31,32,916,916
Precinct,4136362202,192,58,13,15,278,278
Precinct,4136362300,464,194,17,31,706,706
Precinct,4136362301,285,321,33,28,667,667
Precinct,4136362302,351,299,25,27,702,702
Precinct,4136362303,300,187,15,15,517,517
Precinct,4136362304,488,224,19,36,767,767
Precinct,4136362313,254,113,8,16,391,391
Precinct,4234862117,579,130,19,16,744,744
Precinct,4234862131,458,109,19,19,605,605
Precinct,4234862138,713,223,35,13,984,984
Precinct,4234862230,692,288,34,49,1063,1063
Precinct,4234862232,644,241,48,23,956,956
Precinct,4234862244,948,308,53,33,1342,1342
Precinct,4234862245,702,218,20,23,963,963
Precinct,4234962115,1046,397,39,31,1513,1513
Precinct,4234962116,432,208,15,20,675,675
Precinct,4234962121,930,309,42,24,1305,1305
Precinct,4234962122,546,272,35,26,879,879
Precinct,4234962123,517,257,28,33,835,835
Precinct,4234962129,75,16,2,1,94,94
Precinct,4234962130,1174,307,34,44,1559,1559
Precinct,4234962143,431,137,8,20,596,596
Precinct,4234962229,516,150,21,10,697,697
Precinct,4234962231,181,37,7,5,230,230
Precinct,4236362200,996,387,43,29,1455,1455
Precinct,4236362203,694,397,48,38,1177,1177
Precinct,4236362204,683,270,30,21,1004,1004
Precinct,4236362205,498,366,51,35,950,950
Precinct,4236362207,811,373,58,38,1280,1280
Precinct,4236362208,449,172,22,12,655,655
Precinct,4236362237,982,435,34,22,1473,1473
Precinct,4236362239,689,281,28,26,1024,1024
Precinct,4236362240,1122,573,79,58,1832,1832
Precinct,4236362242,480,279,45,29,833,833
Precinct,4236362305,577,329,44,38,988,988
Precinct,4236362306,332,331,29,26,718,718
Precinct,4236362307,533,498,37,23,1091,1091
Precinct,4236362315,0,0,0,0,0,0
Precinct,4236362328,728,481,45,28,1282,1282
Precinct,4236362334,851,549,49,26,1475,1475
Precinct,4236362335,559,295,29,16,899,899
Precinct,4236362337,789,376,39,38,1242,1242
County,Yuma,3500,525,63,65,4153,4153
Precinct,4016563001,278,33,6,12,329,329
Precinct,4016563002,256,45,5,7,313,313
Precinct,4016563003,133,18,3,2,156,156
Precinct,4016563004,481,78,7,10,576,576
Precinct,4016563005,120,11,1,1,133,133
Precinct,4016563006,359,46,8,7,420,420
Precinct,4016563007,95,11,1,0,107,107
Precinct,4016563008,127,20,1,0,148,148
Precinct,4016563009,217,22,2,2,243,243
Precinct,4016563010,235,35,4,3,277,277
Precinct,4016563011,270,58,4,3,335,335
Precinct,4016563012,322,37,8,7,374,374
Precinct,4016563013,299,63,8,5,375,375
Precinct,4016563014,308,48,5,6,367,367